DATE,Year,Day,Drugs,Theft,Violent,Others,Total
1/1/2015,2015,1,43,209,331,171,754
1/2/2015,2015,2,86,191,216,94,587
1/3/2015,2015,3,70,193,233,66,562
1/4/2015,2015,4,66,141,187,56,450
1/5/2015,2015,5,43,164,160,75,442
1/6/2015,2015,6,57,159,136,84,436
1/7/2015,2015,7,61,143,137,80,421
1/8/2015,2015,8,47,144,143,61,395
1/9/2015,2015,9,72,166,171,95,504
1/10/2015,2015,10,78,208,189,87,562
1/11/2015,2015,11,69,196,222,70,557
1/12/2015,2015,12,65,196,183,84,528
1/13/2015,2015,13,77,194,184,82,537
1/14/2015,2015,14,101,195,188,87,571
1/15/2015,2015,15,131,227,196,89,643
1/16/2015,2015,16,79,210,229,92,610
1/17/2015,2015,17,84,212,267,73,636
1/18/2015,2015,18,57,209,289,69,624
1/19/2015,2015,19,92,226,229,84,631
1/20/2015,2015,20,65,254,261,110,690
1/21/2015,2015,21,66,216,247,99,628
1/22/2015,2015,22,92,216,233,98,639
1/23/2015,2015,23,90,206,285,85,666
1/24/2015,2015,24,83,226,252,82,643
1/25/2015,2015,25,58,183,247,79,567
1/26/2015,2015,26,64,207,213,85,569
1/27/2015,2015,27,90,167,202,104,563
1/28/2015,2015,28,83,200,192,90,565
1/29/2015,2015,29,94,207,212,86,599
1/30/2015,2015,30,101,198,212,101,612
1/31/2015,2015,31,75,168,237,67,547
2/1/2015,2015,32,23,136,180,164,503
2/2/2015,2015,33,43,114,158,106,421
2/3/2015,2015,34,46,148,173,88,455
2/4/2015,2015,35,72,150,207,83,512
2/5/2015,2015,36,71,148,190,94,503
2/6/2015,2015,37,103,173,232,97,605
2/7/2015,2015,38,92,148,248,95,583
2/8/2015,2015,39,87,159,228,68,542
2/9/2015,2015,40,79,169,186,98,532
2/10/2015,2015,41,76,157,210,95,538
2/11/2015,2015,42,86,164,192,86,528
2/12/2015,2015,43,80,160,208,91,539
2/13/2015,2015,44,97,155,190,120,562
2/14/2015,2015,45,59,163,217,72,511
2/15/2015,2015,46,72,137,192,87,488
2/16/2015,2015,47,77,134,159,93,463
2/17/2015,2015,48,68,170,199,81,518
2/18/2015,2015,49,55,148,151,93,447
2/19/2015,2015,50,48,146,147,71,412
2/20/2015,2015,51,83,183,193,97,556
2/21/2015,2015,52,85,185,235,73,578
2/22/2015,2015,53,67,137,238,74,516
2/23/2015,2015,54,46,170,188,87,491
2/24/2015,2015,55,73,162,212,84,531
2/25/2015,2015,56,67,136,200,94,497
2/26/2015,2015,57,75,135,166,83,459
2/27/2015,2015,58,80,179,195,111,565
2/28/2015,2015,59,62,145,203,65,475
3/1/2015,2015,60,84,179,246,160,669
3/2/2015,2015,61,97,190,203,85,575
3/3/2015,2015,62,77,160,208,113,558
3/4/2015,2015,63,71,148,200,81,500
3/5/2015,2015,64,79,143,207,105,534
3/6/2015,2015,65,95,183,215,119,612
3/7/2015,2015,66,79,175,261,94,609
3/8/2015,2015,67,90,167,234,47,538
3/9/2015,2015,68,73,183,257,119,632
3/10/2015,2015,69,88,185,265,124,662
3/11/2015,2015,70,71,204,245,120,640
3/12/2015,2015,71,76,200,273,106,655
3/13/2015,2015,72,92,228,289,94,703
3/14/2015,2015,73,79,208,334,84,705
3/15/2015,2015,74,57,199,339,84,679
3/16/2015,2015,75,82,199,288,104,673
3/17/2015,2015,76,98,180,269,77,624
3/18/2015,2015,77,80,177,241,100,598
3/19/2015,2015,78,74,199,285,59,617
3/20/2015,2015,79,81,195,298,94,668
3/21/2015,2015,80,79,181,262,76,598
3/22/2015,2015,81,65,180,264,64,573
3/23/2015,2015,82,54,166,203,90,513
3/24/2015,2015,83,96,176,193,94,559
3/25/2015,2015,84,91,174,258,103,626
3/26/2015,2015,85,83,173,255,76,587
3/27/2015,2015,86,89,196,235,102,622
3/28/2015,2015,87,70,188,244,69,571
3/29/2015,2015,88,78,165,239,72,554
3/30/2015,2015,89,76,197,244,114,631
3/31/2015,2015,90,58,177,256,103,594
4/1/2015,2015,91,71,241,304,186,802
4/2/2015,2015,92,92,218,276,101,687
4/3/2015,2015,93,87,198,250,84,619
4/4/2015,2015,94,71,177,270,97,615
4/5/2015,2015,95,54,165,304,67,590
4/6/2015,2015,96,76,194,239,96,605
4/7/2015,2015,97,72,186,175,97,530
4/8/2015,2015,98,77,200,214,105,596
4/9/2015,2015,99,69,156,224,101,550
4/10/2015,2015,100,72,193,259,113,637
4/11/2015,2015,101,76,177,291,82,626
4/12/2015,2015,102,70,193,324,88,675
4/13/2015,2015,103,62,191,271,124,648
4/14/2015,2015,104,76,184,300,99,659
4/15/2015,2015,105,63,219,281,162,725
4/16/2015,2015,106,77,171,262,84,594
4/17/2015,2015,107,83,214,282,99,678
4/18/2015,2015,108,78,223,296,79,676
4/19/2015,2015,109,70,209,275,63,617
4/20/2015,2015,110,83,219,241,110,653
4/21/2015,2015,111,74,204,211,95,584
4/22/2015,2015,112,64,197,250,86,597
4/23/2015,2015,113,59,193,260,113,625
4/24/2015,2015,114,66,223,283,90,662
4/25/2015,2015,115,64,189,260,97,610
4/26/2015,2015,116,57,187,315,73,632
4/27/2015,2015,117,48,194,284,91,617
4/28/2015,2015,118,52,202,279,91,624
4/29/2015,2015,119,66,225,273,105,669
4/30/2015,2015,120,62,189,226,95,572
5/1/2015,2015,121,65,248,313,195,821
5/2/2015,2015,122,48,195,298,79,620
5/3/2015,2015,123,30,211,368,68,677
5/4/2015,2015,124,64,196,313,108,681
5/5/2015,2015,125,63,191,242,115,611
5/6/2015,2015,126,71,197,261,111,640
5/7/2015,2015,127,84,209,317,87,697
5/8/2015,2015,128,63,237,306,105,711
5/9/2015,2015,129,66,184,281,69,600
5/10/2015,2015,130,56,199,311,83,649
5/11/2015,2015,131,75,203,286,101,665
5/12/2015,2015,132,75,211,267,109,662
5/13/2015,2015,133,72,228,275,102,677
5/14/2015,2015,134,73,223,258,105,659
5/15/2015,2015,135,80,218,313,102,713
5/16/2015,2015,136,52,237,391,103,783
5/17/2015,2015,137,72,198,391,77,738
5/18/2015,2015,138,62,197,293,107,659
5/19/2015,2015,139,66,190,258,108,622
5/20/2015,2015,140,63,201,275,98,637
5/21/2015,2015,141,59,203,261,118,641
5/22/2015,2015,142,76,234,289,98,697
5/23/2015,2015,143,57,232,314,84,687
5/24/2015,2015,144,51,190,296,55,592
5/25/2015,2015,145,54,177,304,71,606
5/26/2015,2015,146,67,209,306,94,676
5/27/2015,2015,147,74,207,268,94,643
5/28/2015,2015,148,55,234,306,89,684
5/29/2015,2015,149,86,260,263,107,716
5/30/2015,2015,150,43,226,281,77,627
5/31/2015,2015,151,54,177,264,82,577
6/1/2015,2015,152,72,242,297,208,819
6/2/2015,2015,153,65,209,285,98,657
6/3/2015,2015,154,70,212,261,120,663
6/4/2015,2015,155,62,230,242,86,620
6/5/2015,2015,156,81,219,280,117,697
6/6/2015,2015,157,75,219,281,83,658
6/7/2015,2015,158,65,197,309,80,651
6/8/2015,2015,159,65,195,237,88,585
6/9/2015,2015,160,61,219,237,102,619
6/10/2015,2015,161,66,233,278,99,676
6/11/2015,2015,162,125,212,254,84,675
6/12/2015,2015,163,66,232,300,95,693
6/13/2015,2015,164,65,230,337,83,715
6/14/2015,2015,165,48,235,321,79,683
6/15/2015,2015,166,16,244,257,133,650
6/16/2015,2015,167,50,252,320,103,725
6/17/2015,2015,168,53,208,273,72,606
6/18/2015,2015,169,47,218,296,88,649
6/19/2015,2015,170,66,257,261,77,661
6/20/2015,2015,171,31,222,329,84,666
6/21/2015,2015,172,32,192,418,54,696
6/22/2015,2015,173,48,242,305,90,685
6/23/2015,2015,174,67,215,268,90,640
6/24/2015,2015,175,62,228,261,72,623
6/25/2015,2015,176,95,229,266,81,671
6/26/2015,2015,177,64,229,275,102,670
6/27/2015,2015,178,46,226,281,82,635
6/28/2015,2015,179,39,207,369,75,690
6/29/2015,2015,180,65,218,267,92,642
6/30/2015,2015,181,76,221,266,81,644
7/1/2015,2015,182,79,242,258,182,761
7/2/2015,2015,183,75,211,271,113,670
7/3/2015,2015,184,66,243,269,92,670
7/4/2015,2015,185,50,226,391,67,734
7/5/2015,2015,186,65,236,407,70,778
7/6/2015,2015,187,56,209,280,113,658
7/7/2015,2015,188,63,215,246,84,608
7/8/2015,2015,189,72,215,231,100,618
7/9/2015,2015,190,65,196,237,77,575
7/10/2015,2015,191,75,249,233,104,661
7/11/2015,2015,192,66,227,330,68,691
7/12/2015,2015,193,68,229,336,87,720
7/13/2015,2015,194,60,221,284,121,686
7/14/2015,2015,195,65,237,228,82,612
7/15/2015,2015,196,66,257,269,112,704
7/16/2015,2015,197,42,209,232,97,580
7/17/2015,2015,198,75,262,264,106,707
7/18/2015,2015,199,49,216,325,86,676
7/19/2015,2015,200,40,225,328,71,664
7/20/2015,2015,201,59,254,276,104,693
7/21/2015,2015,202,57,233,282,92,664
7/22/2015,2015,203,72,226,279,99,676
7/23/2015,2015,204,69,251,292,92,704
7/24/2015,2015,205,72,274,309,94,749
7/25/2015,2015,206,50,240,343,90,723
7/26/2015,2015,207,60,221,349,71,701
7/27/2015,2015,208,52,265,307,101,725
7/28/2015,2015,209,52,234,284,90,660
7/29/2015,2015,210,63,226,291,91,671
7/30/2015,2015,211,70,219,282,99,670
7/31/2015,2015,212,55,238,275,102,670
8/1/2015,2015,213,64,334,338,168,904
8/2/2015,2015,214,64,242,329,70,705
8/3/2015,2015,215,52,224,270,107,653
8/4/2015,2015,216,83,237,273,81,674
8/5/2015,2015,217,76,236,259,98,669
8/6/2015,2015,218,78,249,266,101,694
8/7/2015,2015,219,71,255,292,100,718
8/8/2015,2015,220,59,239,343,98,739
8/9/2015,2015,221,69,210,306,69,654
8/10/2015,2015,222,59,249,292,108,708
8/11/2015,2015,223,68,229,276,104,677
8/12/2015,2015,224,84,234,263,88,669
8/13/2015,2015,225,64,219,295,100,678
8/14/2015,2015,226,67,248,285,91,691
8/15/2015,2015,227,47,237,334,87,705
8/16/2015,2015,228,58,240,395,57,750
8/17/2015,2015,229,48,214,265,105,632
8/18/2015,2015,230,59,237,253,96,645
8/19/2015,2015,231,74,244,276,102,696
8/20/2015,2015,232,108,265,238,101,712
8/21/2015,2015,233,90,285,281,101,757
8/22/2015,2015,234,57,238,352,97,744
8/23/2015,2015,235,70,228,323,81,702
8/24/2015,2015,236,62,216,253,91,622
8/25/2015,2015,237,55,256,249,107,667
8/26/2015,2015,238,67,254,237,120,678
8/27/2015,2015,239,72,265,232,101,670
8/28/2015,2015,240,72,268,258,109,707
8/29/2015,2015,241,65,201,323,83,672
8/30/2015,2015,242,69,234,301,87,691
8/31/2015,2015,243,67,238,252,93,650
9/1/2015,2015,244,74,265,291,178,808
9/2/2015,2015,245,77,233,265,101,676
9/3/2015,2015,246,80,302,294,100,776
9/4/2015,2015,247,68,258,265,121,712
9/5/2015,2015,248,56,235,299,65,655
9/6/2015,2015,249,77,220,349,62,708
9/7/2015,2015,250,80,223,326,76,705
9/8/2015,2015,251,61,231,234,105,631
9/9/2015,2015,252,70,213,240,87,610
9/10/2015,2015,253,56,206,233,80,575
9/11/2015,2015,254,74,197,229,95,595
9/12/2015,2015,255,51,215,282,94,642
9/13/2015,2015,256,56,206,327,57,646
9/14/2015,2015,257,56,265,277,92,690
9/15/2015,2015,258,66,254,256,125,701
9/16/2015,2015,259,82,245,260,84,671
9/17/2015,2015,260,66,229,248,81,624
9/18/2015,2015,261,52,248,275,108,683
9/19/2015,2015,262,77,248,294,84,703
9/20/2015,2015,263,67,238,328,91,724
9/21/2015,2015,264,67,207,271,84,629
9/22/2015,2015,265,77,217,270,96,660
9/23/2015,2015,266,85,252,289,95,721
9/24/2015,2015,267,67,222,254,77,620
9/25/2015,2015,268,73,219,303,104,699
9/26/2015,2015,269,57,233,334,76,700
9/27/2015,2015,270,75,217,328,70,690
9/28/2015,2015,271,68,241,263,85,657
9/29/2015,2015,272,59,211,223,93,586
9/30/2015,2015,273,73,225,208,84,590
10/1/2015,2015,274,82,251,236,195,764
10/2/2015,2015,275,105,249,240,108,702
10/3/2015,2015,276,63,236,227,85,611
10/4/2015,2015,277,64,197,253,68,582
10/5/2015,2015,278,79,224,234,118,655
10/6/2015,2015,279,84,221,232,105,642
10/7/2015,2015,280,68,201,261,94,624
10/8/2015,2015,281,64,228,254,83,629
10/9/2015,2015,282,100,248,251,106,705
10/10/2015,2015,283,62,217,270,89,638
10/11/2015,2015,284,41,199,337,68,645
10/12/2015,2015,285,58,209,276,92,635
10/13/2015,2015,286,61,207,279,92,639
10/14/2015,2015,287,77,220,252,95,644
10/15/2015,2015,288,80,251,251,125,707
10/16/2015,2015,289,71,224,243,94,632
10/17/2015,2015,290,54,225,270,62,611
10/18/2015,2015,291,56,156,307,66,585
10/19/2015,2015,292,60,254,278,85,677
10/20/2015,2015,293,86,244,247,98,675
10/21/2015,2015,294,77,251,280,90,698
10/22/2015,2015,295,76,209,270,111,666
10/23/2015,2015,296,85,221,253,95,654
10/24/2015,2015,297,46,237,299,73,655
10/25/2015,2015,298,59,232,283,55,629
10/26/2015,2015,299,51,247,271,103,672
10/27/2015,2015,300,43,207,238,81,569
10/28/2015,2015,301,54,207,210,103,574
10/29/2015,2015,302,56,228,229,82,595
10/30/2015,2015,303,96,240,230,103,669
10/31/2015,2015,304,47,212,297,72,628
11/1/2015,2015,305,69,263,350,167,849
11/2/2015,2015,306,76,211,289,110,686
11/3/2015,2015,307,55,231,265,103,654
11/4/2015,2015,308,79,228,259,100,666
11/5/2015,2015,309,66,236,258,87,647
11/6/2015,2015,310,79,245,233,81,638
11/7/2015,2015,311,56,209,253,82,600
11/8/2015,2015,312,69,216,279,60,624
11/9/2015,2015,313,64,206,236,88,594
11/10/2015,2015,314,57,180,237,83,557
11/11/2015,2015,315,71,193,208,103,575
11/12/2015,2015,316,68,206,197,105,576
11/13/2015,2015,317,67,215,233,83,598
11/14/2015,2015,318,61,226,257,68,612
11/15/2015,2015,319,65,207,258,94,624
11/16/2015,2015,320,57,227,256,98,638
11/17/2015,2015,321,58,199,227,83,567
11/18/2015,2015,322,66,214,225,87,592
11/19/2015,2015,323,93,211,216,86,606
11/20/2015,2015,324,78,231,225,83,617
11/21/2015,2015,325,39,172,191,63,465
11/22/2015,2015,326,40,140,208,77,465
11/23/2015,2015,327,54,216,209,86,565
11/24/2015,2015,328,47,190,202,73,512
11/25/2015,2015,329,44,197,219,73,533
11/26/2015,2015,330,24,166,270,51,511
11/27/2015,2015,331,37,223,218,76,554
11/28/2015,2015,332,41,192,265,69,567
11/29/2015,2015,333,45,187,230,60,522
11/30/2015,2015,334,57,213,220,105,595
12/1/2015,2015,335,66,211,226,173,676
12/2/2015,2015,336,74,250,227,85,636
12/3/2015,2015,337,59,243,229,102,633
12/4/2015,2015,338,61,229,230,93,613
12/5/2015,2015,339,43,215,287,84,629
12/6/2015,2015,340,49,227,257,73,606
12/7/2015,2015,341,45,234,228,89,596
12/8/2015,2015,342,58,235,236,105,634
12/9/2015,2015,343,39,232,219,89,579
12/10/2015,2015,344,41,226,234,91,592
12/11/2015,2015,345,48,265,251,70,634
12/12/2015,2015,346,36,229,299,86,650
12/13/2015,2015,347,28,236,273,43,580
12/14/2015,2015,348,36,258,248,90,632
12/15/2015,2015,349,56,251,259,100,666
12/16/2015,2015,350,50,229,242,97,618
12/17/2015,2015,351,45,261,216,105,627
12/18/2015,2015,352,46,222,220,83,571
12/19/2015,2015,353,44,231,239,81,595
12/20/2015,2015,354,46,218,261,84,609
12/21/2015,2015,355,35,217,219,96,567
12/22/2015,2015,356,38,255,228,86,607
12/23/2015,2015,357,31,281,235,89,636
12/24/2015,2015,358,11,205,282,80,578
12/25/2015,2015,359,11,133,251,42,437
12/26/2015,2015,360,38,189,269,71,567
12/27/2015,2015,361,38,227,245,58,568
12/28/2015,2015,362,19,179,177,68,443
12/29/2015,2015,363,50,213,196,88,547
12/30/2015,2015,364,35,184,225,89,533
12/31/2015,2015,365,21,198,204,103,526
1/1/2016,2016,1,21,182,385,303,891
1/2/2016,2016,2,29,182,210,87,508
1/3/2016,2016,3,29,219,244,69,561
1/4/2016,2016,4,23,200,216,85,524
1/5/2016,2016,5,39,207,219,99,564
1/6/2016,2016,6,34,199,220,108,561
1/7/2016,2016,7,43,229,232,96,600
1/8/2016,2016,8,48,237,262,96,643
1/9/2016,2016,9,38,192,262,78,570
1/10/2016,2016,10,29,184,213,95,521
1/11/2016,2016,11,16,194,169,77,456
1/12/2016,2016,12,35,176,174,78,463
1/13/2016,2016,13,35,209,209,105,558
1/14/2016,2016,14,49,206,265,100,620
1/15/2016,2016,15,38,241,266,100,645
1/16/2016,2016,16,38,200,242,92,572
1/17/2016,2016,17,26,151,231,72,480
1/18/2016,2016,18,36,178,183,77,474
1/19/2016,2016,19,33,206,193,98,530
1/20/2016,2016,20,35,218,213,81,547
1/21/2016,2016,21,34,222,202,88,546
1/22/2016,2016,22,54,248,236,77,615
1/23/2016,2016,23,42,243,267,88,640
1/24/2016,2016,24,26,229,261,76,592
1/25/2016,2016,25,33,236,269,104,642
1/26/2016,2016,26,42,187,210,113,552
1/27/2016,2016,27,33,228,229,98,588
1/28/2016,2016,28,103,218,221,94,636
1/29/2016,2016,29,45,261,228,98,632
1/30/2016,2016,30,36,223,309,90,658
1/31/2016,2016,31,25,205,288,68,586
2/1/2016,2016,32,47,236,244,206,733
2/2/2016,2016,33,38,173,199,111,521
2/3/2016,2016,34,42,206,235,117,600
2/4/2016,2016,35,53,178,253,94,578
2/5/2016,2016,36,48,201,226,97,572
2/6/2016,2016,37,42,198,262,105,607
2/7/2016,2016,38,29,185,258,85,557
2/8/2016,2016,39,29,177,200,87,493
2/9/2016,2016,40,34,168,189,94,485
2/10/2016,2016,41,43,150,194,110,497
2/11/2016,2016,42,43,193,185,98,519
2/12/2016,2016,43,73,198,195,108,574
2/13/2016,2016,44,48,197,214,75,534
2/14/2016,2016,45,28,143,212,63,446
2/15/2016,2016,46,54,153,199,91,497
2/16/2016,2016,47,36,212,227,85,560
2/17/2016,2016,48,50,170,243,102,565
2/18/2016,2016,49,44,231,236,90,601
2/19/2016,2016,50,60,240,264,104,668
2/20/2016,2016,51,47,188,300,92,627
2/21/2016,2016,52,54,192,330,68,644
2/22/2016,2016,53,47,186,244,86,563
2/23/2016,2016,54,33,191,218,99,541
2/24/2016,2016,55,35,173,207,93,508
2/25/2016,2016,56,95,194,228,108,625
2/26/2016,2016,57,45,223,271,113,652
2/27/2016,2016,58,41,211,277,93,622
2/28/2016,2016,59,33,182,273,73,561
2/29/2016,2016,60,32,194,244,100,570
3/1/2016,2016,61,52,223,217,219,711
3/2/2016,2016,62,59,182,197,85,523
3/3/2016,2016,63,58,183,201,100,542
3/4/2016,2016,64,69,196,252,95,612
3/5/2016,2016,65,36,219,269,86,610
3/6/2016,2016,66,53,203,289,98,643
3/7/2016,2016,67,66,221,293,125,705
3/8/2016,2016,68,30,204,302,103,639
3/9/2016,2016,69,55,156,283,106,600
3/10/2016,2016,70,61,200,272,108,641
3/11/2016,2016,71,59,208,263,102,632
3/12/2016,2016,72,30,223,329,90,672
3/13/2016,2016,73,33,172,268,73,546
3/14/2016,2016,74,42,186,249,110,587
3/15/2016,2016,75,47,201,261,108,617
3/16/2016,2016,76,47,193,293,111,644
3/17/2016,2016,77,42,225,280,100,647
3/18/2016,2016,78,65,217,297,103,682
3/19/2016,2016,79,44,202,272,80,598
3/20/2016,2016,80,38,189,300,87,614
3/21/2016,2016,81,41,178,266,126,611
3/22/2016,2016,82,42,192,298,91,623
3/23/2016,2016,83,35,215,245,106,601
3/24/2016,2016,84,42,198,259,102,601
3/25/2016,2016,85,43,220,261,102,626
3/26/2016,2016,86,44,198,315,87,644
3/27/2016,2016,87,31,173,287,61,552
3/28/2016,2016,88,52,202,286,108,648
3/29/2016,2016,89,64,206,271,106,647
3/30/2016,2016,90,51,222,280,88,641
3/31/2016,2016,91,45,220,302,101,668
4/1/2016,2016,92,44,225,258,191,718
4/2/2016,2016,93,45,192,241,92,570
4/3/2016,2016,94,41,223,277,95,636
4/4/2016,2016,95,40,200,221,117,578
4/5/2016,2016,96,60,183,232,111,586
4/6/2016,2016,97,62,182,252,82,578
4/7/2016,2016,98,92,208,256,98,654
4/8/2016,2016,99,40,207,213,83,543
4/9/2016,2016,100,44,211,250,101,606
4/10/2016,2016,101,39,198,275,108,620
4/11/2016,2016,102,33,196,246,120,595
4/12/2016,2016,103,57,205,237,111,610
4/13/2016,2016,104,50,185,285,104,624
4/14/2016,2016,105,51,187,269,84,591
4/15/2016,2016,106,84,262,253,115,714
4/16/2016,2016,107,37,206,311,81,635
4/17/2016,2016,108,38,195,316,80,629
4/18/2016,2016,109,36,232,272,94,634
4/19/2016,2016,110,47,214,282,82,625
4/20/2016,2016,111,49,203,245,91,588
4/21/2016,2016,112,48,195,263,110,616
4/22/2016,2016,113,55,219,259,98,631
4/23/2016,2016,114,33,172,300,92,597
4/24/2016,2016,115,58,196,332,81,667
4/25/2016,2016,116,42,217,306,105,670
4/26/2016,2016,117,51,195,241,102,589
4/27/2016,2016,118,44,195,245,96,580
4/28/2016,2016,119,45,213,265,107,630
4/29/2016,2016,120,57,214,289,85,645
4/30/2016,2016,121,37,192,239,75,543
5/1/2016,2016,122,26,239,285,173,723
5/2/2016,2016,123,45,241,261,115,662
5/3/2016,2016,124,45,215,258,114,632
5/4/2016,2016,125,55,180,269,89,593
5/5/2016,2016,126,51,222,235,102,610
5/6/2016,2016,127,42,243,317,110,712
5/7/2016,2016,128,14,232,327,82,655
5/8/2016,2016,129,32,183,341,83,639
5/9/2016,2016,130,43,194,290,103,630
5/10/2016,2016,131,41,188,277,106,612
5/11/2016,2016,132,44,236,275,99,654
5/12/2016,2016,133,49,206,259,82,596
5/13/2016,2016,134,47,242,297,111,697
5/14/2016,2016,135,50,210,275,98,633
5/15/2016,2016,136,40,207,324,84,655
5/16/2016,2016,137,52,223,291,117,683
5/17/2016,2016,138,45,198,237,105,585
5/18/2016,2016,139,46,232,318,85,681
5/19/2016,2016,140,84,213,282,92,671
5/20/2016,2016,141,55,229,313,103,700
5/21/2016,2016,142,37,216,333,92,678
5/22/2016,2016,143,48,231,319,65,663
5/23/2016,2016,144,45,236,279,116,676
5/24/2016,2016,145,46,225,329,94,694
5/25/2016,2016,146,34,194,299,100,627
5/26/2016,2016,147,43,231,307,104,685
5/27/2016,2016,148,50,252,290,94,686
5/28/2016,2016,149,48,254,322,76,700
5/29/2016,2016,150,46,204,372,72,694
5/30/2016,2016,151,44,234,378,78,734
5/31/2016,2016,152,54,221,278,114,667
6/1/2016,2016,153,46,253,290,204,793
6/2/2016,2016,154,44,237,316,103,700
6/3/2016,2016,155,58,231,312,110,711
6/4/2016,2016,156,40,205,345,147,737
6/5/2016,2016,157,42,241,309,107,699
6/6/2016,2016,158,43,231,305,132,711
6/7/2016,2016,159,49,212,286,114,661
6/8/2016,2016,160,50,238,259,94,641
6/9/2016,2016,161,39,197,266,129,631
6/10/2016,2016,162,44,243,286,94,667
6/11/2016,2016,163,43,242,358,96,739
6/12/2016,2016,164,54,257,356,74,741
6/13/2016,2016,165,33,241,309,123,706
6/14/2016,2016,166,48,231,314,135,728
6/15/2016,2016,167,49,231,300,111,691
6/16/2016,2016,168,37,256,299,110,702
6/17/2016,2016,169,41,240,317,113,711
6/18/2016,2016,170,34,239,324,72,669
6/19/2016,2016,171,22,246,375,63,706
6/20/2016,2016,172,36,241,348,118,743
6/21/2016,2016,173,34,256,336,107,733
6/22/2016,2016,174,39,221,289,104,653
6/23/2016,2016,175,45,253,285,100,683
6/24/2016,2016,176,50,265,306,85,706
6/25/2016,2016,177,28,267,317,86,698
6/26/2016,2016,178,24,227,354,74,679
6/27/2016,2016,179,41,248,278,97,664
6/28/2016,2016,180,47,242,274,107,670
6/29/2016,2016,181,43,231,298,103,675
6/30/2016,2016,182,75,273,299,101,748
7/1/2016,2016,183,65,258,303,179,805
7/2/2016,2016,184,52,226,289,92,659
7/3/2016,2016,185,53,225,331,78,687
7/4/2016,2016,186,38,209,416,73,736
7/5/2016,2016,187,49,253,398,95,795
7/6/2016,2016,188,34,237,285,90,646
7/7/2016,2016,189,50,257,265,110,682
7/8/2016,2016,190,36,261,288,98,683
7/9/2016,2016,191,28,229,307,81,645
7/10/2016,2016,192,22,246,317,83,668
7/11/2016,2016,193,31,222,268,92,613
7/12/2016,2016,194,36,244,272,132,684
7/13/2016,2016,195,45,239,257,101,642
7/14/2016,2016,196,49,256,255,103,663
7/15/2016,2016,197,48,296,293,106,743
7/16/2016,2016,198,30,258,322,80,690
7/17/2016,2016,199,30,220,338,80,668
7/18/2016,2016,200,39,265,280,105,689
7/19/2016,2016,201,44,263,280,99,686
7/20/2016,2016,202,38,262,297,118,715
7/21/2016,2016,203,42,273,258,118,691
7/22/2016,2016,204,48,248,291,97,684
7/23/2016,2016,205,30,289,322,68,709
7/24/2016,2016,206,34,253,338,70,695
7/25/2016,2016,207,45,259,297,109,710
7/26/2016,2016,208,46,301,301,111,759
7/27/2016,2016,209,40,274,283,98,695
7/28/2016,2016,210,50,248,272,106,676
7/29/2016,2016,211,36,284,258,113,691
7/30/2016,2016,212,35,327,373,92,827
7/31/2016,2016,213,21,305,333,64,723
8/1/2016,2016,214,31,275,282,195,783
8/2/2016,2016,215,25,267,289,115,696
8/3/2016,2016,216,39,262,262,112,675
8/4/2016,2016,217,32,254,303,120,709
8/5/2016,2016,218,33,289,317,107,746
8/6/2016,2016,219,26,251,368,93,738
8/7/2016,2016,220,38,267,349,82,736
8/8/2016,2016,221,29,284,271,113,697
8/9/2016,2016,222,32,211,271,122,636
8/10/2016,2016,223,26,223,268,114,631
8/11/2016,2016,224,37,256,329,110,732
8/12/2016,2016,225,35,279,249,93,656
8/13/2016,2016,226,18,273,323,100,714
8/14/2016,2016,227,24,277,350,73,724
8/15/2016,2016,228,27,258,317,135,737
8/16/2016,2016,229,31,277,284,132,724
8/17/2016,2016,230,29,298,326,104,757
8/18/2016,2016,231,41,257,252,110,660
8/19/2016,2016,232,33,267,288,89,677
8/20/2016,2016,233,22,288,348,101,759
8/21/2016,2016,234,14,229,358,73,674
8/22/2016,2016,235,28,257,257,90,632
8/23/2016,2016,236,24,251,266,94,635
8/24/2016,2016,237,28,275,290,112,705
8/25/2016,2016,238,18,270,278,89,655
8/26/2016,2016,239,24,287,280,101,692
8/27/2016,2016,240,17,279,334,82,712
8/28/2016,2016,241,23,264,344,77,708
8/29/2016,2016,242,30,302,335,100,767
8/30/2016,2016,243,24,262,262,89,637
8/31/2016,2016,244,26,281,271,90,668
9/1/2016,2016,245,60,305,322,205,892
9/2/2016,2016,246,36,276,278,99,689
9/3/2016,2016,247,37,265,307,81,690
9/4/2016,2016,248,31,234,320,82,667
9/5/2016,2016,249,32,257,341,84,714
9/6/2016,2016,250,28,241,257,119,645
9/7/2016,2016,251,32,224,285,98,639
9/8/2016,2016,252,30,287,272,96,685
9/9/2016,2016,253,37,261,297,105,700
9/10/2016,2016,254,26,249,308,77,660
9/11/2016,2016,255,19,258,312,69,658
9/12/2016,2016,256,28,240,306,104,678
9/13/2016,2016,257,24,249,301,95,669
9/14/2016,2016,258,35,294,258,123,710
9/15/2016,2016,259,19,294,294,113,720
9/16/2016,2016,260,27,246,293,110,676
9/17/2016,2016,261,25,256,359,78,718
9/18/2016,2016,262,26,247,349,65,687
9/19/2016,2016,263,19,246,272,88,625
9/20/2016,2016,264,25,272,276,113,686
9/21/2016,2016,265,28,233,273,102,636
9/22/2016,2016,266,44,282,291,112,729
9/23/2016,2016,267,66,271,294,99,730
9/24/2016,2016,268,16,249,364,112,741
9/25/2016,2016,269,20,276,352,78,726
9/26/2016,2016,270,18,273,255,108,654
9/27/2016,2016,271,33,244,268,82,627
9/28/2016,2016,272,19,230,225,74,548
9/29/2016,2016,273,28,225,251,105,609
9/30/2016,2016,274,29,259,281,101,670
10/1/2016,2016,275,18,283,287,160,748
10/2/2016,2016,276,19,236,310,61,626
10/3/2016,2016,277,20,284,260,112,676
10/4/2016,2016,278,31,229,252,112,624
10/5/2016,2016,279,42,249,268,131,690
10/6/2016,2016,280,25,253,251,118,647
10/7/2016,2016,281,26,279,313,135,753
10/8/2016,2016,282,14,229,308,70,621
10/9/2016,2016,283,11,220,311,65,607
10/10/2016,2016,284,21,254,256,98,629
10/11/2016,2016,285,19,238,230,119,606
10/12/2016,2016,286,23,260,249,96,628
10/13/2016,2016,287,33,232,231,113,609
10/14/2016,2016,288,26,269,291,109,695
10/15/2016,2016,289,23,263,319,109,714
10/16/2016,2016,290,26,261,329,86,702
10/17/2016,2016,291,29,255,308,116,708
10/18/2016,2016,292,27,253,291,98,669
10/19/2016,2016,293,26,225,272,87,610
10/20/2016,2016,294,28,237,264,86,615
10/21/2016,2016,295,34,272,262,98,666
10/22/2016,2016,296,28,263,281,107,679
10/23/2016,2016,297,23,265,319,81,688
10/24/2016,2016,298,37,266,251,103,657
10/25/2016,2016,299,25,259,250,91,625
10/26/2016,2016,300,21,254,223,102,600
10/27/2016,2016,301,25,273,248,90,636
10/28/2016,2016,302,20,294,281,108,703
10/29/2016,2016,303,20,222,374,111,727
10/30/2016,2016,304,23,238,332,102,695
10/31/2016,2016,305,19,267,345,123,754
11/1/2016,2016,306,31,269,298,185,783
11/2/2016,2016,307,17,270,291,77,655
11/3/2016,2016,308,9,236,354,97,696
11/4/2016,2016,309,19,284,288,97,688
11/5/2016,2016,310,22,291,332,77,722
11/6/2016,2016,311,23,245,335,70,673
11/7/2016,2016,312,17,249,265,101,632
11/8/2016,2016,313,20,203,225,95,543
11/9/2016,2016,314,20,267,230,74,591
11/10/2016,2016,315,25,255,251,102,633
11/11/2016,2016,316,46,282,246,114,688
11/12/2016,2016,317,32,269,307,76,684
11/13/2016,2016,318,26,236,246,74,582
11/14/2016,2016,319,23,226,230,87,566
11/15/2016,2016,320,23,231,242,107,603
11/16/2016,2016,321,25,258,273,103,659
11/17/2016,2016,322,47,273,269,92,681
11/18/2016,2016,323,41,273,255,112,681
11/19/2016,2016,324,14,242,264,75,595
11/20/2016,2016,325,24,197,271,88,580
11/21/2016,2016,326,34,242,200,106,582
11/22/2016,2016,327,37,252,221,98,608
11/23/2016,2016,328,15,256,204,111,586
11/24/2016,2016,329,4,146,251,60,461
11/25/2016,2016,330,35,251,237,90,613
11/26/2016,2016,331,35,253,264,75,627
11/27/2016,2016,332,35,228,276,75,614
11/28/2016,2016,333,20,273,221,87,601
11/29/2016,2016,334,28,236,235,95,594
11/30/2016,2016,335,31,243,244,91,609
12/1/2016,2016,336,14,273,235,196,718
12/2/2016,2016,337,43,281,266,125,715
12/3/2016,2016,338,23,286,265,88,662
12/4/2016,2016,339,19,216,244,58,537
12/5/2016,2016,340,25,223,220,110,578
12/6/2016,2016,341,32,248,222,91,593
12/7/2016,2016,342,18,233,231,88,570
12/8/2016,2016,343,24,235,179,87,525
12/9/2016,2016,344,31,227,203,121,582
12/10/2016,2016,345,32,212,213,86,543
12/11/2016,2016,346,21,178,207,58,464
12/12/2016,2016,347,31,202,178,112,523
12/13/2016,2016,348,24,212,166,104,506
12/14/2016,2016,349,29,228,179,90,526
12/15/2016,2016,350,21,207,176,112,516
12/16/2016,2016,351,25,256,215,103,599
12/17/2016,2016,352,24,243,205,80,552
12/18/2016,2016,353,23,162,220,66,471
12/19/2016,2016,354,17,223,207,137,584
12/20/2016,2016,355,20,275,186,119,600
12/21/2016,2016,356,33,255,230,119,637
12/22/2016,2016,357,24,245,231,98,598
12/23/2016,2016,358,29,264,238,106,637
12/24/2016,2016,359,6,220,222,69,517
12/25/2016,2016,360,5,127,227,47,406
12/26/2016,2016,361,12,214,262,75,563
12/27/2016,2016,362,28,222,226,112,588
12/28/2016,2016,363,20,259,216,127,622
12/29/2016,2016,364,30,205,219,107,561
12/30/2016,2016,365,27,253,234,128,642
12/31/2016,2016,1,14,233,287,80,614
1/1/2017,2017,2,12,261,368,270,911
1/2/2017,2017,3,28,190,216,99,533
1/3/2017,2017,4,38,218,251,120,627
1/4/2017,2017,5,25,222,186,113,546
1/5/2017,2017,6,25,205,193,121,544
1/6/2017,2017,7,29,211,193,87,520
1/7/2017,2017,8,32,201,224,89,546
1/8/2017,2017,9,25,187,230,82,524
1/9/2017,2017,10,37,238,220,109,604
1/10/2017,2017,11,21,212,246,125,604
1/11/2017,2017,12,30,217,214,111,572
1/12/2017,2017,13,24,214,197,115,550
1/13/2017,2017,14,38,283,234,121,676
1/14/2017,2017,15,38,208,246,101,593
1/15/2017,2017,16,29,222,231,85,567
1/16/2017,2017,17,21,228,233,81,563
1/17/2017,2017,18,31,244,222,104,601
1/18/2017,2017,19,24,236,213,113,586
1/19/2017,2017,20,56,244,234,114,648
1/20/2017,2017,21,45,264,265,103,677
1/21/2017,2017,22,37,266,288,94,685
1/22/2017,2017,23,33,235,268,94,630
1/23/2017,2017,24,29,260,284,109,682
1/24/2017,2017,25,28,238,257,112,635
1/25/2017,2017,26,26,263,237,107,633
1/26/2017,2017,27,34,251,206,85,576
1/27/2017,2017,28,59,255,226,131,671
1/28/2017,2017,29,35,243,263,87,628
1/29/2017,2017,30,36,196,238,69,539
1/30/2017,2017,31,24,241,254,117,636
1/31/2017,2017,32,36,250,229,106,621
2/1/2017,2017,33,38,254,241,179,712
2/2/2017,2017,34,32,228,206,118,584
2/3/2017,2017,35,58,212,197,105,572
2/4/2017,2017,36,37,231,222,75,565
2/5/2017,2017,37,23,247,266,82,618
2/6/2017,2017,38,29,237,272,120,658
2/7/2017,2017,39,25,220,239,119,603
2/8/2017,2017,40,31,211,228,117,587
2/9/2017,2017,41,39,216,202,108,565
2/10/2017,2017,42,46,215,262,126,649
2/11/2017,2017,43,27,247,231,91,596
2/12/2017,2017,44,30,211,291,77,609
2/13/2017,2017,45,29,235,250,109,623
2/14/2017,2017,46,25,212,254,109,600
2/15/2017,2017,47,39,202,234,105,580
2/16/2017,2017,48,34,248,205,94,581
2/17/2017,2017,49,43,257,273,138,711
2/18/2017,2017,50,30,219,283,102,634
2/19/2017,2017,51,29,215,290,65,599
2/20/2017,2017,52,32,203,275,91,601
2/21/2017,2017,53,29,210,241,101,581
2/22/2017,2017,54,27,196,261,115,599
2/23/2017,2017,55,58,177,229,117,581
2/24/2017,2017,56,32,199,231,102,564
2/25/2017,2017,57,40,180,222,73,515
2/26/2017,2017,58,39,177,222,86,524
2/27/2017,2017,59,31,204,224,101,560
2/28/2017,2017,60,24,200,207,96,527
3/1/2017,2017,61,41,202,204,195,642
3/2/2017,2017,62,51,175,212,117,555
3/3/2017,2017,63,46,219,225,112,602
3/4/2017,2017,64,43,190,229,80,542
3/5/2017,2017,65,39,208,256,77,580
3/6/2017,2017,66,35,214,260,98,607
3/7/2017,2017,67,27,201,248,119,595
3/8/2017,2017,68,39,181,242,118,580
3/9/2017,2017,69,47,197,241,95,580
3/10/2017,2017,70,41,208,209,114,572
3/11/2017,2017,71,27,192,271,91,581
3/12/2017,2017,72,36,144,218,93,491
3/13/2017,2017,73,22,155,194,90,461
3/14/2017,2017,74,20,127,164,103,414
3/15/2017,2017,75,41,178,221,103,543
3/16/2017,2017,76,36,212,228,101,577
3/17/2017,2017,77,43,219,253,106,621
3/18/2017,2017,78,30,202,283,74,589
3/19/2017,2017,79,33,149,272,77,531
3/20/2017,2017,80,30,191,264,118,603
3/21/2017,2017,81,37,194,234,101,566
3/22/2017,2017,82,26,199,254,74,553
3/23/2017,2017,83,46,194,248,98,586
3/24/2017,2017,84,42,229,297,105,673
3/25/2017,2017,85,39,213,275,86,613
3/26/2017,2017,86,36,202,308,89,635
3/27/2017,2017,87,34,219,265,113,631
3/28/2017,2017,88,23,207,254,95,579
3/29/2017,2017,89,35,215,237,104,591
3/30/2017,2017,90,35,221,249,101,606
3/31/2017,2017,91,47,228,268,125,668
4/1/2017,2017,92,29,251,273,157,710
4/2/2017,2017,93,30,207,294,80,611
4/3/2017,2017,94,31,217,253,111,612
4/4/2017,2017,95,35,184,266,134,619
4/5/2017,2017,96,21,205,219,103,548
4/6/2017,2017,97,29,216,243,92,580
4/7/2017,2017,98,43,221,240,114,618
4/8/2017,2017,99,34,202,295,90,621
4/9/2017,2017,100,43,208,341,80,672
4/10/2017,2017,101,35,187,250,137,609
4/11/2017,2017,102,59,222,225,114,620
4/12/2017,2017,103,21,231,263,115,630
4/13/2017,2017,104,28,214,236,103,581
4/14/2017,2017,105,42,235,284,120,681
4/15/2017,2017,106,24,241,349,104,718
4/16/2017,2017,107,20,167,338,78,603
4/17/2017,2017,108,28,217,286,123,654
4/18/2017,2017,109,41,212,273,100,626
4/19/2017,2017,110,37,237,257,112,643
4/20/2017,2017,111,34,235,253,85,607
4/21/2017,2017,112,56,258,250,133,697
4/22/2017,2017,113,40,191,288,95,614
4/23/2017,2017,114,31,225,283,80,619
4/24/2017,2017,115,22,214,283,97,616
4/25/2017,2017,116,31,240,272,107,650
4/26/2017,2017,117,47,197,318,95,657
4/27/2017,2017,118,42,223,251,112,628
4/28/2017,2017,119,50,241,299,106,696
4/29/2017,2017,120,27,203,233,82,545
4/30/2017,2017,121,33,190,275,78,576
5/1/2017,2017,122,32,237,253,219,741
5/2/2017,2017,123,36,204,255,114,609
5/3/2017,2017,124,40,221,267,111,639
5/4/2017,2017,125,47,239,276,93,655
5/5/2017,2017,126,51,212,289,129,681
5/6/2017,2017,127,32,242,282,84,640
5/7/2017,2017,128,13,197,277,64,551
5/8/2017,2017,129,43,228,226,113,610
5/9/2017,2017,130,34,224,250,103,611
5/10/2017,2017,131,27,208,236,98,569
5/11/2017,2017,132,38,235,277,82,632
5/12/2017,2017,133,48,267,300,128,743
5/13/2017,2017,134,36,209,292,89,626
5/14/2017,2017,135,25,209,311,78,623
5/15/2017,2017,136,44,267,328,133,772
5/16/2017,2017,137,36,235,297,86,654
5/17/2017,2017,138,37,251,359,86,733
5/18/2017,2017,139,30,237,306,109,682
5/19/2017,2017,140,45,260,274,103,682
5/20/2017,2017,141,39,215,244,86,584
5/21/2017,2017,142,35,212,380,86,713
5/22/2017,2017,143,33,244,294,109,680
5/23/2017,2017,144,39,229,264,105,637
5/24/2017,2017,145,34,264,273,94,665
5/25/2017,2017,146,29,228,290,118,665
5/26/2017,2017,147,45,243,245,113,646
5/27/2017,2017,148,51,217,328,72,668
5/28/2017,2017,149,26,178,307,88,599
5/29/2017,2017,150,34,207,335,82,658
5/30/2017,2017,151,21,252,325,114,712
5/31/2017,2017,152,38,201,294,107,640
6/1/2017,2017,153,38,245,278,193,754
6/2/2017,2017,154,45,272,324,97,738
6/3/2017,2017,155,27,263,342,91,723
6/4/2017,2017,156,35,245,370,77,727
6/5/2017,2017,157,25,243,283,96,647
6/6/2017,2017,158,33,256,331,114,734
6/7/2017,2017,159,22,254,291,105,672
6/8/2017,2017,160,17,253,281,105,656
6/9/2017,2017,161,31,266,283,93,673
6/10/2017,2017,162,29,272,301,88,690
6/11/2017,2017,163,26,253,365,83,727
6/12/2017,2017,164,39,253,276,86,654
6/13/2017,2017,165,30,278,285,117,710
6/14/2017,2017,166,23,271,274,106,674
6/15/2017,2017,167,25,259,299,112,695
6/16/2017,2017,168,31,269,308,122,730
6/17/2017,2017,169,23,268,338,95,724
6/18/2017,2017,170,14,241,351,75,681
6/19/2017,2017,171,30,235,299,89,653
6/20/2017,2017,172,32,258,329,84,703
6/21/2017,2017,173,32,273,251,116,672
6/22/2017,2017,174,22,286,288,118,714
6/23/2017,2017,175,29,270,278,97,674
6/24/2017,2017,176,40,260,337,90,727
6/25/2017,2017,177,18,241,364,77,700
6/26/2017,2017,178,32,270,280,107,689
6/27/2017,2017,179,34,268,274,91,667
6/28/2017,2017,180,27,244,239,94,604
6/29/2017,2017,181,26,252,291,104,673
6/30/2017,2017,182,30,269,280,97,676
7/1/2017,2017,183,34,257,326,187,804
7/2/2017,2017,184,28,239,330,68,665
7/3/2017,2017,185,63,281,299,119,762
7/4/2017,2017,186,22,233,343,82,680
7/5/2017,2017,187,31,257,341,110,739
7/6/2017,2017,188,24,266,274,92,656
7/7/2017,2017,189,29,236,291,102,658
7/8/2017,2017,190,27,236,292,94,649
7/9/2017,2017,191,33,271,355,70,729
7/10/2017,2017,192,42,253,263,108,666
7/11/2017,2017,193,30,261,266,110,667
7/12/2017,2017,194,25,247,252,89,613
7/13/2017,2017,195,42,272,297,94,705
7/14/2017,2017,196,43,259,293,92,687
7/15/2017,2017,197,38,291,330,117,776
7/16/2017,2017,198,34,252,343,76,705
7/17/2017,2017,199,33,309,283,125,750
7/18/2017,2017,200,21,260,277,119,677
7/19/2017,2017,201,41,273,249,99,662
7/20/2017,2017,202,31,257,262,104,654
7/21/2017,2017,203,37,267,257,84,645
7/22/2017,2017,204,30,246,305,80,661
7/23/2017,2017,205,28,248,374,79,729
7/24/2017,2017,206,27,235,273,138,673
7/25/2017,2017,207,30,290,290,134,744
7/26/2017,2017,208,33,234,273,103,643
7/27/2017,2017,209,31,287,278,94,690
7/28/2017,2017,210,29,315,283,115,742
7/29/2017,2017,211,29,231,346,95,701
7/30/2017,2017,212,32,254,353,80,719
7/31/2017,2017,213,27,268,270,114,679
8/1/2017,2017,214,34,326,306,192,858
8/2/2017,2017,215,33,238,297,124,692
8/3/2017,2017,216,33,287,305,112,737
8/4/2017,2017,217,37,380,269,128,814
8/5/2017,2017,218,23,387,295,121,826
8/6/2017,2017,219,35,300,363,78,776
8/7/2017,2017,220,37,250,287,95,669
8/8/2017,2017,221,40,260,258,109,667
8/9/2017,2017,222,26,274,258,111,669
8/10/2017,2017,223,29,257,299,98,683
8/11/2017,2017,224,32,264,278,75,649
8/12/2017,2017,225,27,278,311,78,694
8/13/2017,2017,226,15,222,300,78,615
8/14/2017,2017,227,30,300,298,95,723
8/15/2017,2017,228,17,320,264,92,693
8/16/2017,2017,229,23,298,269,110,700
8/17/2017,2017,230,33,271,258,113,675
8/18/2017,2017,231,46,286,307,106,745
8/19/2017,2017,232,32,304,365,92,793
8/20/2017,2017,233,18,232,327,83,660
8/21/2017,2017,234,17,274,295,90,676
8/22/2017,2017,235,25,281,276,91,673
8/23/2017,2017,236,32,266,254,90,642
8/24/2017,2017,237,35,283,252,115,685
8/25/2017,2017,238,70,248,259,91,668
8/26/2017,2017,239,30,268,298,84,680
8/27/2017,2017,240,16,247,321,70,654
8/28/2017,2017,241,33,244,220,102,599
8/29/2017,2017,242,35,241,239,89,604
8/30/2017,2017,243,50,283,257,88,678
8/31/2017,2017,244,52,219,264,107,642
9/1/2017,2017,245,56,271,275,190,792
9/2/2017,2017,246,58,258,269,89,674
9/3/2017,2017,247,43,215,320,83,661
9/4/2017,2017,248,51,197,300,83,631
9/5/2017,2017,249,53,215,251,106,625
9/6/2017,2017,250,34,213,230,93,570
9/7/2017,2017,251,28,271,243,91,633
9/8/2017,2017,252,24,232,255,90,601
9/9/2017,2017,253,23,248,277,97,645
9/10/2017,2017,254,24,245,307,77,653
9/11/2017,2017,255,28,239,231,110,608
9/12/2017,2017,256,33,248,235,100,616
9/13/2017,2017,257,30,227,251,89,597
9/14/2017,2017,258,31,259,260,106,656
9/15/2017,2017,259,29,285,296,94,704
9/16/2017,2017,260,31,267,349,84,731
9/17/2017,2017,261,22,259,356,81,718
9/18/2017,2017,262,23,257,286,107,673
9/19/2017,2017,263,28,245,256,85,614
9/20/2017,2017,264,38,253,322,111,724
9/21/2017,2017,265,35,268,312,102,717
9/22/2017,2017,266,41,256,295,92,684
9/23/2017,2017,267,21,250,366,86,723
9/24/2017,2017,268,32,247,361,84,724
9/25/2017,2017,269,40,276,306,115,737
9/26/2017,2017,270,33,245,278,106,662
9/27/2017,2017,271,36,242,268,88,634
9/28/2017,2017,272,30,234,261,92,617
9/29/2017,2017,273,43,267,283,91,684
9/30/2017,2017,274,29,254,299,82,664
10/1/2017,2017,275,26,258,319,144,747
10/2/2017,2017,276,24,263,271,96,654
10/3/2017,2017,277,33,266,236,104,639
10/4/2017,2017,278,27,256,264,93,640
10/5/2017,2017,279,35,239,274,103,651
10/6/2017,2017,280,27,262,252,104,645
10/7/2017,2017,281,20,262,275,74,631
10/8/2017,2017,282,22,228,316,59,625
10/9/2017,2017,283,21,271,278,88,658
10/10/2017,2017,284,24,241,249,105,619
10/11/2017,2017,285,29,210,207,74,520
10/12/2017,2017,286,31,254,259,120,664
10/13/2017,2017,287,30,252,277,84,643
10/14/2017,2017,288,14,238,251,72,575
10/15/2017,2017,289,20,226,265,58,569
10/16/2017,2017,290,23,275,270,102,670
10/17/2017,2017,291,30,212,256,112,610
10/18/2017,2017,292,26,264,258,108,656
10/19/2017,2017,293,22,259,279,103,663
10/20/2017,2017,294,34,298,292,104,728
10/21/2017,2017,295,33,268,315,98,714
10/22/2017,2017,296,31,249,291,71,642
10/23/2017,2017,297,30,257,236,125,648
10/24/2017,2017,298,27,265,214,88,594
10/25/2017,2017,299,33,241,245,92,611
10/26/2017,2017,300,37,249,241,104,631
10/27/2017,2017,301,26,302,270,118,716
10/28/2017,2017,302,26,260,255,96,637
10/29/2017,2017,303,31,232,285,75,623
10/30/2017,2017,304,33,239,239,88,599
10/31/2017,2017,305,21,240,299,120,680
11/1/2017,2017,306,35,233,276,160,704
11/2/2017,2017,307,24,231,263,95,613
11/3/2017,2017,308,38,295,254,112,699
11/4/2017,2017,309,28,271,272,86,657
11/5/2017,2017,310,34,239,329,81,683
11/6/2017,2017,311,38,263,222,93,616
11/7/2017,2017,312,29,234,235,90,588
11/8/2017,2017,313,27,278,263,83,651
11/9/2017,2017,314,40,234,205,103,582
11/10/2017,2017,315,32,235,217,104,588
11/11/2017,2017,316,28,251,244,82,605
11/12/2017,2017,317,19,219,266,70,574
11/13/2017,2017,318,28,254,249,107,638
11/14/2017,2017,319,27,238,239,107,611
11/15/2017,2017,320,36,236,238,107,617
11/16/2017,2017,321,49,282,229,103,663
11/17/2017,2017,322,38,252,214,113,617
11/18/2017,2017,323,23,262,254,82,621
11/19/2017,2017,324,23,229,292,61,605
11/20/2017,2017,325,40,285,247,93,665
11/21/2017,2017,326,38,236,232,80,586
11/22/2017,2017,327,40,238,194,99,571
11/23/2017,2017,328,7,164,259,51,481
11/24/2017,2017,329,23,246,241,101,611
11/25/2017,2017,330,20,263,283,72,638
11/26/2017,2017,331,29,230,251,71,581
11/27/2017,2017,332,28,273,276,108,685
11/28/2017,2017,333,47,246,256,127,676
11/29/2017,2017,334,21,253,278,119,671
11/30/2017,2017,335,38,277,235,111,661
12/1/2017,2017,336,37,315,270,169,791
12/2/2017,2017,337,22,272,259,87,640
12/3/2017,2017,338,16,222,289,69,596
12/4/2017,2017,339,41,279,304,93,717
12/5/2017,2017,340,37,244,229,118,628
12/6/2017,2017,341,36,245,244,108,633
12/7/2017,2017,342,25,216,222,93,556
12/8/2017,2017,343,28,264,257,93,642
12/9/2017,2017,344,21,248,237,75,581
12/10/2017,2017,345,26,213,243,88,570
12/11/2017,2017,346,23,259,247,119,648
12/12/2017,2017,347,24,242,227,111,604
12/13/2017,2017,348,31,231,223,109,594
12/14/2017,2017,349,18,246,244,118,626
12/15/2017,2017,350,22,262,234,150,668
12/16/2017,2017,351,32,295,262,97,686
12/17/2017,2017,352,30,252,256,96,634
12/18/2017,2017,353,23,273,235,121,652
12/19/2017,2017,354,20,288,255,106,669
12/20/2017,2017,355,40,259,232,93,624
12/21/2017,2017,356,31,279,230,105,645
12/22/2017,2017,357,33,298,232,109,672
12/23/2017,2017,358,17,271,267,80,635
12/24/2017,2017,359,8,212,190,42,452
12/25/2017,2017,360,3,119,197,34,353
12/26/2017,2017,361,19,182,175,86,462
12/27/2017,2017,362,29,189,162,87,467
12/28/2017,2017,363,34,235,176,102,547
12/29/2017,2017,364,22,216,169,90,497
12/30/2017,2017,365,27,228,213,102,570
12/31/2017,2017,1,14,184,220,48,466
1/1/2018,2018,2,17,231,267,188,703
1/2/2018,2018,3,25,207,163,112,507
1/3/2018,2018,4,34,221,158,95,508
1/4/2018,2018,5,22,212,191,91,516
1/5/2018,2018,6,28,242,223,104,597
1/6/2018,2018,7,21,169,231,78,499
1/7/2018,2018,8,18,182,214,58,472
1/8/2018,2018,9,43,229,192,77,541
1/9/2018,2018,10,48,230,191,87,556
1/10/2018,2018,11,46,241,236,95,618
1/11/2018,2018,12,35,211,255,110,611
1/12/2018,2018,13,40,244,235,103,622
1/13/2018,2018,14,26,199,225,93,543
1/14/2018,2018,15,22,180,228,70,500
1/15/2018,2018,16,35,175,164,87,461
1/16/2018,2018,17,33,212,202,102,549
1/17/2018,2018,18,39,205,221,87,552
1/18/2018,2018,19,31,215,194,96,536
1/19/2018,2018,20,49,231,220,112,612
1/20/2018,2018,21,49,249,253,92,643
1/21/2018,2018,22,41,229,282,77,629
1/22/2018,2018,23,37,255,229,97,618
1/23/2018,2018,24,42,240,235,103,620
1/24/2018,2018,25,43,188,208,92,531
1/25/2018,2018,26,35,209,250,83,577
1/26/2018,2018,27,45,218,283,99,645
1/27/2018,2018,28,45,241,265,103,654
1/28/2018,2018,29,37,191,272,86,586
1/29/2018,2018,30,23,240,207,115,585
1/30/2018,2018,31,30,214,211,90,545
1/31/2018,2018,32,44,249,232,90,615
2/1/2018,2018,33,34,226,207,176,643
2/2/2018,2018,34,50,221,190,121,582
2/3/2018,2018,35,41,182,219,107,549
2/4/2018,2018,36,16,137,226,68,447
2/5/2018,2018,37,22,170,189,94,475
2/6/2018,2018,38,40,183,187,95,505
2/7/2018,2018,39,36,161,167,91,455
2/8/2018,2018,40,43,167,170,114,494
2/9/2018,2018,41,17,154,174,85,430
2/10/2018,2018,42,30,168,194,80,472
2/11/2018,2018,43,28,132,230,75,465
2/12/2018,2018,44,50,160,203,95,508
2/13/2018,2018,45,40,211,205,106,562
2/14/2018,2018,46,42,179,261,104,586
2/15/2018,2018,47,52,201,254,116,623
2/16/2018,2018,48,26,211,248,92,577
2/17/2018,2018,49,11,201,247,90,549
2/18/2018,2018,50,19,160,257,58,494
2/19/2018,2018,51,30,188,242,89,549
2/20/2018,2018,52,33,163,232,121,549
2/21/2018,2018,53,40,206,222,96,564
2/22/2018,2018,54,38,206,251,93,588
2/23/2018,2018,55,53,214,222,100,589
2/24/2018,2018,56,32,195,289,85,601
2/25/2018,2018,57,31,207,273,78,589
2/26/2018,2018,58,45,171,233,94,543
2/27/2018,2018,59,55,197,231,108,591
2/28/2018,2018,60,42,190,204,118,554
3/1/2018,2018,61,36,214,289,189,728
3/2/2018,2018,62,51,200,248,110,609
3/3/2018,2018,63,42,183,282,89,596
3/4/2018,2018,64,46,191,262,85,584
3/5/2018,2018,65,47,191,244,100,582
3/6/2018,2018,66,42,190,234,119,585
3/7/2018,2018,67,50,211,201,107,569
3/8/2018,2018,68,36,167,241,104,548
3/9/2018,2018,69,43,225,252,115,635
3/10/2018,2018,70,42,203,274,89,608
3/11/2018,2018,71,36,176,272,62,546
3/12/2018,2018,72,35,215,229,94,573
3/13/2018,2018,73,34,200,242,90,566
3/14/2018,2018,74,46,184,258,90,578
3/15/2018,2018,75,38,216,254,109,617
3/16/2018,2018,76,50,198,263,99,610
3/17/2018,2018,77,47,214,342,90,693
3/18/2018,2018,78,34,194,276,106,610
3/19/2018,2018,79,40,204,231,105,580
3/20/2018,2018,80,46,192,252,124,614
3/21/2018,2018,81,36,198,258,108,600
3/22/2018,2018,82,39,208,229,111,587
3/23/2018,2018,83,57,219,274,102,652
3/24/2018,2018,84,28,210,248,78,564
3/25/2018,2018,85,43,179,292,77,591
3/26/2018,2018,86,40,220,227,122,609
3/27/2018,2018,87,32,209,248,103,592
3/28/2018,2018,88,52,206,246,94,598
3/29/2018,2018,89,40,181,226,99,546
3/30/2018,2018,90,35,232,234,113,614
3/31/2018,2018,91,39,195,286,86,606
4/1/2018,2018,92,31,200,253,154,638
4/2/2018,2018,93,42,204,246,98,590
4/3/2018,2018,94,43,180,191,108,522
4/4/2018,2018,95,34,217,247,113,611
4/5/2018,2018,96,33,195,246,117,591
4/6/2018,2018,97,36,197,253,107,593
4/7/2018,2018,98,41,172,284,68,565
4/8/2018,2018,99,35,201,246,87,569
4/9/2018,2018,100,38,205,238,107,588
4/10/2018,2018,101,51,216,231,113,611
4/11/2018,2018,102,38,230,289,93,650
4/12/2018,2018,103,34,224,294,101,653
4/13/2018,2018,104,49,257,271,117,694
4/14/2018,2018,105,30,231,240,95,596
4/15/2018,2018,106,27,194,242,75,538
4/16/2018,2018,107,21,226,274,94,615
4/17/2018,2018,108,31,220,229,114,594
4/18/2018,2018,109,22,203,218,102,545
4/19/2018,2018,110,43,212,225,123,603
4/20/2018,2018,111,54,247,277,109,687
4/21/2018,2018,112,44,187,281,83,595
4/22/2018,2018,113,35,197,296,76,604
4/23/2018,2018,114,25,218,260,112,615
4/24/2018,2018,115,27,234,264,92,617
4/25/2018,2018,116,39,243,261,100,643
4/26/2018,2018,117,32,246,237,136,651
4/27/2018,2018,118,56,225,272,106,659
4/28/2018,2018,119,37,231,234,96,598
4/29/2018,2018,120,42,212,291,83,628
4/30/2018,2018,121,31,219,293,129,672
5/1/2018,2018,122,31,284,367,217,899
5/2/2018,2018,123,45,244,285,114,688
5/3/2018,2018,124,36,207,296,115,654
5/4/2018,2018,125,57,227,324,88,696
5/5/2018,2018,126,36,261,369,100,766
5/6/2018,2018,127,24,199,339,69,631
5/7/2018,2018,128,44,253,290,112,699
5/8/2018,2018,129,34,230,297,116,677
5/9/2018,2018,130,26,241,300,103,670
5/10/2018,2018,131,36,246,271,120,673
5/11/2018,2018,132,41,212,273,95,621
5/12/2018,2018,133,34,210,275,89,608
5/13/2018,2018,134,32,203,310,63,608
5/14/2018,2018,135,33,241,304,111,689
5/15/2018,2018,136,25,244,280,116,665
5/16/2018,2018,137,39,218,315,89,661
5/17/2018,2018,138,29,260,304,101,694
5/18/2018,2018,139,47,244,262,136,689
5/19/2018,2018,140,53,241,292,80,666
5/20/2018,2018,141,35,223,312,103,673
5/21/2018,2018,142,50,232,248,102,632
5/22/2018,2018,143,39,224,305,123,691
5/23/2018,2018,144,37,239,299,115,690
5/24/2018,2018,145,50,238,302,113,703
5/25/2018,2018,146,26,227,334,124,711
5/26/2018,2018,147,42,246,384,83,755
5/27/2018,2018,148,46,234,404,84,768
5/28/2018,2018,149,48,245,361,99,753
5/29/2018,2018,150,33,274,356,112,775
5/30/2018,2018,151,36,273,318,119,746
5/31/2018,2018,152,33,251,312,121,717
6/1/2018,2018,153,43,297,324,192,856
6/2/2018,2018,154,50,241,322,118,731
6/3/2018,2018,155,37,255,353,83,728
6/4/2018,2018,156,30,243,300,126,699
6/5/2018,2018,157,37,250,268,107,662
6/6/2018,2018,158,35,269,292,134,730
6/7/2018,2018,159,35,229,308,105,677
6/8/2018,2018,160,46,234,285,92,657
6/9/2018,2018,161,40,275,308,79,702
6/10/2018,2018,162,38,261,274,65,638
6/11/2018,2018,163,39,246,258,113,656
6/12/2018,2018,164,32,257,294,111,694
6/13/2018,2018,165,33,231,294,97,655
6/14/2018,2018,166,39,238,282,83,642
6/15/2018,2018,167,42,240,293,152,727
6/16/2018,2018,168,32,254,343,90,719
6/17/2018,2018,169,20,235,397,78,730
6/18/2018,2018,170,29,262,339,110,740
6/19/2018,2018,171,35,236,312,103,686
6/20/2018,2018,172,43,283,319,114,759
6/21/2018,2018,173,31,236,200,115,582
6/22/2018,2018,174,44,238,253,89,624
6/23/2018,2018,175,37,279,321,94,731
6/24/2018,2018,176,20,286,369,81,756
6/25/2018,2018,177,34,288,308,108,738
6/26/2018,2018,178,31,268,289,106,694
6/27/2018,2018,179,39,273,284,113,709
6/28/2018,2018,180,33,275,289,117,714
6/29/2018,2018,181,31,253,293,97,674
6/30/2018,2018,182,46,279,339,102,766
7/1/2018,2018,183,56,257,354,170,837
7/2/2018,2018,184,37,277,324,123,761
7/3/2018,2018,185,55,253,276,109,693
7/4/2018,2018,186,36,206,395,68,705
7/5/2018,2018,187,63,240,323,96,722
7/6/2018,2018,188,64,273,296,137,770
7/7/2018,2018,189,41,254,334,110,739
7/8/2018,2018,190,39,217,379,80,715
7/9/2018,2018,191,34,258,288,114,694
7/10/2018,2018,192,37,280,280,112,709
7/11/2018,2018,193,24,235,270,103,632
7/12/2018,2018,194,43,279,279,105,706
7/13/2018,2018,195,34,291,301,94,720
7/14/2018,2018,196,36,232,335,80,683
7/15/2018,2018,197,30,248,338,101,717
7/16/2018,2018,198,40,240,294,116,690
7/17/2018,2018,199,40,236,277,95,648
7/18/2018,2018,200,29,260,320,128,737
7/19/2018,2018,201,25,275,268,117,685
7/20/2018,2018,202,38,282,281,132,733
7/21/2018,2018,203,37,243,341,83,704
7/22/2018,2018,204,45,246,317,82,690
7/23/2018,2018,205,35,270,319,114,738
7/24/2018,2018,206,34,256,304,111,705
7/25/2018,2018,207,47,251,299,110,707
7/26/2018,2018,208,38,265,278,105,686
7/27/2018,2018,209,42,234,287,113,676
7/28/2018,2018,210,30,251,308,98,687
7/29/2018,2018,211,28,249,318,73,668
7/30/2018,2018,212,22,282,261,117,682
7/31/2018,2018,213,35,259,310,134,738
8/1/2018,2018,214,35,291,305,178,809
8/2/2018,2018,215,26,336,282,98,742
8/3/2018,2018,216,38,338,283,136,795
8/4/2018,2018,217,37,305,351,79,772
8/5/2018,2018,218,19,269,373,92,753
8/6/2018,2018,219,37,271,256,119,683
8/7/2018,2018,220,41,288,238,113,680
8/8/2018,2018,221,38,276,257,120,691
8/9/2018,2018,222,32,258,272,96,658
8/10/2018,2018,223,48,297,277,108,730
8/11/2018,2018,224,43,270,336,89,738
8/12/2018,2018,225,47,230,376,99,752
8/13/2018,2018,226,34,279,286,125,724
8/14/2018,2018,227,48,290,295,97,730
8/15/2018,2018,228,41,278,262,102,683
8/16/2018,2018,229,39,279,304,101,723
8/17/2018,2018,230,52,261,284,97,694
8/18/2018,2018,231,50,281,334,117,782
8/19/2018,2018,232,43,231,335,85,694
8/20/2018,2018,233,37,239,242,110,628
8/21/2018,2018,234,41,241,246,99,627
8/22/2018,2018,235,41,283,309,95,728
8/23/2018,2018,236,27,251,271,91,640
8/24/2018,2018,237,49,259,266,110,684
8/25/2018,2018,238,60,253,324,103,740
8/26/2018,2018,239,47,217,363,72,699
8/27/2018,2018,240,38,283,288,105,714
8/28/2018,2018,241,41,257,295,111,704
8/29/2018,2018,242,34,253,247,122,656
8/30/2018,2018,243,48,276,270,102,696
8/31/2018,2018,244,63,258,272,118,711
9/1/2018,2018,245,69,267,322,169,827
9/2/2018,2018,246,62,236,319,91,708
9/3/2018,2018,247,55,229,300,93,677
9/4/2018,2018,248,51,255,294,111,711
9/5/2018,2018,249,37,232,264,94,627
9/6/2018,2018,250,51,237,247,100,635
9/7/2018,2018,251,53,233,219,120,625
9/8/2018,2018,252,38,262,301,80,681
9/9/2018,2018,253,23,218,275,78,594
9/10/2018,2018,254,21,258,237,106,622
9/11/2018,2018,255,39,210,253,91,593
9/12/2018,2018,256,30,226,265,94,615
9/13/2018,2018,257,33,228,243,94,598
9/14/2018,2018,258,44,269,322,113,748
9/15/2018,2018,259,44,246,323,85,698
9/16/2018,2018,260,47,247,346,67,707
9/17/2018,2018,261,25,275,270,117,687
9/18/2018,2018,262,29,239,271,92,631
9/19/2018,2018,263,31,251,281,85,648
9/20/2018,2018,264,35,260,323,104,722
9/21/2018,2018,265,29,270,301,113,713
9/22/2018,2018,266,41,280,326,66,713
9/23/2018,2018,267,34,239,303,79,655
9/24/2018,2018,268,37,275,268,106,686
9/25/2018,2018,269,23,253,280,93,649
9/26/2018,2018,270,35,254,268,95,652
9/27/2018,2018,271,32,239,228,94,593
9/28/2018,2018,272,49,256,264,109,678
9/29/2018,2018,273,44,264,257,69,634
9/30/2018,2018,274,35,251,283,82,651
10/1/2018,2018,275,36,268,292,183,779
10/2/2018,2018,276,26,265,240,98,629
10/3/2018,2018,277,20,222,267,83,592
10/4/2018,2018,278,18,225,274,103,620
10/5/2018,2018,279,22,203,241,103,569
10/6/2018,2018,280,13,249,306,73,641
10/7/2018,2018,281,23,219,322,67,631
10/8/2018,2018,282,32,218,299,90,639
10/9/2018,2018,283,40,220,284,99,643
10/10/2018,2018,284,40,219,273,109,641
10/11/2018,2018,285,38,232,227,83,580
10/12/2018,2018,286,42,234,241,112,629
10/13/2018,2018,287,36,252,263,77,628
10/14/2018,2018,288,25,216,308,65,614
10/15/2018,2018,289,28,239,252,111,630
10/16/2018,2018,290,29,227,232,99,587
10/17/2018,2018,291,43,209,219,108,579
10/18/2018,2018,292,37,242,242,94,615
10/19/2018,2018,293,43,258,270,96,667
10/20/2018,2018,294,33,258,310,100,701
10/21/2018,2018,295,31,207,261,72,571
10/22/2018,2018,296,37,217,273,89,616
10/23/2018,2018,297,39,227,282,105,653
10/24/2018,2018,298,42,272,290,97,701
10/25/2018,2018,299,31,232,284,90,637
10/26/2018,2018,300,49,265,286,105,705
10/27/2018,2018,301,26,258,310,85,679
10/28/2018,2018,302,31,230,298,73,632
10/29/2018,2018,303,36,226,256,101,619
10/30/2018,2018,304,54,243,273,104,674
10/31/2018,2018,305,49,248,368,114,779
11/1/2018,2018,306,35,275,312,197,819
11/2/2018,2018,307,61,260,256,105,682
11/3/2018,2018,308,44,244,299,101,688
11/4/2018,2018,309,24,225,270,89,608
11/5/2018,2018,310,40,201,247,105,593
11/6/2018,2018,311,40,243,252,118,653
11/7/2018,2018,312,42,234,221,95,592
11/8/2018,2018,313,34,233,234,94,595
11/9/2018,2018,314,49,243,238,91,621
11/10/2018,2018,315,35,211,239,75,560
11/11/2018,2018,316,29,198,261,74,562
11/12/2018,2018,317,44,217,243,90,594
11/13/2018,2018,318,43,215,178,96,532
11/14/2018,2018,319,43,227,191,99,560
11/15/2018,2018,320,44,237,200,109,590
11/16/2018,2018,321,63,234,237,109,643
11/17/2018,2018,322,43,216,232,92,583
11/18/2018,2018,323,30,187,250,87,554
11/19/2018,2018,324,28,205,233,101,567
11/20/2018,2018,325,37,250,213,105,605
11/21/2018,2018,326,52,267,236,91,646
11/22/2018,2018,327,14,153,241,53,461
11/23/2018,2018,328,46,237,278,100,661
11/24/2018,2018,329,31,263,222,90,606
11/25/2018,2018,330,15,174,252,67,508
11/26/2018,2018,331,24,175,201,97,497
11/27/2018,2018,332,34,238,200,100,572
11/28/2018,2018,333,44,237,228,110,619
11/29/2018,2018,334,48,240,232,98,618
11/30/2018,2018,335,43,234,256,102,635
12/1/2018,2018,336,36,260,263,155,714
12/2/2018,2018,337,31,226,282,83,622
12/3/2018,2018,338,31,265,240,113,649
12/4/2018,2018,339,51,248,215,122,636
12/5/2018,2018,340,35,225,228,132,620
12/6/2018,2018,341,33,259,244,93,629
12/7/2018,2018,342,39,243,258,118,658
12/8/2018,2018,343,38,255,279,89,661
12/9/2018,2018,344,27,225,283,76,611
12/10/2018,2018,345,38,243,218,112,611
12/11/2018,2018,346,30,230,224,100,584
12/12/2018,2018,347,39,274,238,124,675
12/13/2018,2018,348,24,219,225,114,582
12/14/2018,2018,349,41,271,271,108,691
12/15/2018,2018,350,34,257,282,87,660
12/16/2018,2018,351,46,233,295,90,664
12/17/2018,2018,352,36,268,228,96,628
12/18/2018,2018,353,32,259,210,123,624
12/19/2018,2018,354,36,263,258,96,653
12/20/2018,2018,355,21,310,248,117,696
12/21/2018,2018,356,30,309,253,108,700
12/22/2018,2018,357,16,269,294,85,664
12/23/2018,2018,358,25,203,271,63,562
12/24/2018,2018,359,16,206,223,84,529
12/25/2018,2018,360,8,102,233,45,388
12/26/2018,2018,361,41,209,211,87,548
12/27/2018,2018,362,27,227,202,81,537
12/28/2018,2018,363,55,251,229,92,627
12/29/2018,2018,364,38,204,277,81,600
12/30/2018,2018,365,32,212,272,76,592
12/31/2018,2018,1,21,225,242,75,563
1/1/2019,2019,2,36,212,405,230,883
1/2/2019,2019,3,49,205,209,107,570
1/3/2019,2019,4,53,252,246,115,666
1/4/2019,2019,5,68,246,238,111,663
1/5/2019,2019,6,75,221,276,103,675
1/6/2019,2019,7,39,192,267,76,574
1/7/2019,2019,8,36,201,233,105,575
1/8/2019,2019,9,46,203,260,97,606
1/9/2019,2019,10,55,208,197,98,558
1/10/2019,2019,11,46,191,235,104,576
1/11/2019,2019,12,65,255,236,119,675
1/12/2019,2019,13,48,203,233,99,583
1/13/2019,2019,14,36,160,222,54,472
1/14/2019,2019,15,30,211,227,84,552
1/15/2019,2019,16,45,210,232,121,608
1/16/2019,2019,17,55,227,211,122,615
1/17/2019,2019,18,37,211,214,109,571
1/18/2019,2019,19,36,216,221,105,578
1/19/2019,2019,20,30,149,184,72,435
1/20/2019,2019,21,23,135,200,77,435
1/21/2019,2019,22,42,183,175,86,486
1/22/2019,2019,23,45,188,200,98,531
1/23/2019,2019,24,81,220,202,79,582
1/24/2019,2019,25,41,179,208,89,517
1/25/2019,2019,26,50,175,183,97,505
1/26/2019,2019,27,40,162,197,69,468
1/27/2019,2019,28,38,156,194,75,463
1/28/2019,2019,29,36,136,198,99,469
1/29/2019,2019,30,35,166,169,71,441
1/30/2019,2019,31,9,96,134,64,303
1/31/2019,2019,32,15,154,171,79,419
2/1/2019,2019,33,62,216,204,183,665
2/2/2019,2019,34,55,221,252,105,633
2/3/2019,2019,35,31,165,255,69,520
2/4/2019,2019,36,40,214,279,97,630
2/5/2019,2019,37,46,197,220,98,561
2/6/2019,2019,38,49,185,235,88,557
2/7/2019,2019,39,47,203,248,90,588
2/8/2019,2019,40,62,215,193,97,567
2/9/2019,2019,41,62,223,264,108,657
2/10/2019,2019,42,37,180,258,82,557
2/11/2019,2019,43,42,204,196,88,530
2/12/2019,2019,44,48,199,239,99,585
2/13/2019,2019,45,44,188,225,101,558
2/14/2019,2019,46,46,213,279,123,661
2/15/2019,2019,47,58,225,248,126,657
2/16/2019,2019,48,40,212,253,102,607
2/17/2019,2019,49,38,191,250,63,542
2/18/2019,2019,50,33,190,215,76,514
2/19/2019,2019,51,40,169,216,105,530
2/20/2019,2019,52,42,198,217,104,561
2/21/2019,2019,53,44,220,236,101,601
2/22/2019,2019,54,57,197,228,120,602
2/23/2019,2019,55,56,191,241,84,572
2/24/2019,2019,56,33,174,202,66,475
2/25/2019,2019,57,44,194,201,92,531
2/26/2019,2019,58,32,182,220,105,539
2/27/2019,2019,59,54,186,221,107,568
2/28/2019,2019,60,29,191,186,112,518
3/1/2019,2019,61,60,198,207,183,648
3/2/2019,2019,62,54,184,251,84,573
3/3/2019,2019,63,37,135,227,86,485
3/4/2019,2019,64,44,153,189,107,493
3/5/2019,2019,65,46,161,179,93,479
3/6/2019,2019,66,49,181,219,113,562
3/7/2019,2019,67,49,192,204,102,547
3/8/2019,2019,68,58,197,259,99,613
3/9/2019,2019,69,52,166,257,73,548
3/10/2019,2019,70,43,156,268,75,542
3/11/2019,2019,71,42,217,247,109,615
3/12/2019,2019,72,44,186,222,99,551
3/13/2019,2019,73,38,191,277,99,605
3/14/2019,2019,74,44,173,251,114,582
3/15/2019,2019,75,53,210,277,101,641
3/16/2019,2019,76,45,199,332,97,673
3/17/2019,2019,77,26,159,276,67,528
3/18/2019,2019,78,42,175,273,87,577
3/19/2019,2019,79,47,176,247,84,554
3/20/2019,2019,80,46,199,226,126,597
3/21/2019,2019,81,39,218,264,90,611
3/22/2019,2019,82,57,211,249,100,617
3/23/2019,2019,83,44,197,285,78,604
3/24/2019,2019,84,32,188,275,77,572
3/25/2019,2019,85,47,181,226,110,564
3/26/2019,2019,86,46,197,240,103,586
3/27/2019,2019,87,43,164,275,110,592
3/28/2019,2019,88,44,189,270,100,603
3/29/2019,2019,89,49,201,257,91,598
3/30/2019,2019,90,49,185,252,76,562
3/31/2019,2019,91,39,165,272,78,554
4/1/2019,2019,92,37,212,265,180,694
4/2/2019,2019,93,48,178,238,114,578
4/3/2019,2019,94,49,187,245,115,596
4/4/2019,2019,95,42,191,256,102,591
4/5/2019,2019,96,60,217,264,86,627
4/6/2019,2019,97,41,196,291,104,632
4/7/2019,2019,98,44,185,297,79,605
4/8/2019,2019,99,46,202,296,110,654
4/9/2019,2019,100,50,182,280,86,598
4/10/2019,2019,101,35,218,212,107,572
4/11/2019,2019,102,45,218,265,108,636
4/12/2019,2019,103,59,226,263,122,670
4/13/2019,2019,104,44,216,310,97,667
4/14/2019,2019,105,31,144,226,75,476
4/15/2019,2019,106,44,227,253,126,650
4/16/2019,2019,107,39,195,280,122,636
4/17/2019,2019,108,39,216,242,93,590
4/18/2019,2019,109,34,181,240,84,539
4/19/2019,2019,110,56,196,226,83,561
4/20/2019,2019,111,45,204,295,84,628
4/21/2019,2019,112,37,154,320,52,563
4/22/2019,2019,113,42,176,306,110,634
4/23/2019,2019,114,51,236,261,101,649
4/24/2019,2019,115,40,200,248,115,603
4/25/2019,2019,116,34,214,300,107,655
4/26/2019,2019,117,50,229,272,116,667
4/27/2019,2019,118,29,187,266,69,551
4/28/2019,2019,119,37,168,262,61,528
4/29/2019,2019,120,40,237,243,102,622
4/30/2019,2019,121,43,228,266,98,635
5/1/2019,2019,122,35,235,289,154,713
5/2/2019,2019,123,36,212,251,99,598
5/3/2019,2019,124,58,258,260,107,683
5/4/2019,2019,125,36,183,309,78,606
5/5/2019,2019,126,26,200,365,92,683
5/6/2019,2019,127,37,237,296,112,682
5/7/2019,2019,128,37,217,257,104,615
5/8/2019,2019,129,40,211,300,106,657
5/9/2019,2019,130,48,202,279,104,633
5/10/2019,2019,131,46,214,298,123,681
5/11/2019,2019,132,46,235,257,65,603
5/12/2019,2019,133,26,171,265,87,549
5/13/2019,2019,134,31,223,314,120,688
5/14/2019,2019,135,40,207,282,92,621
5/15/2019,2019,136,31,241,292,102,666
5/16/2019,2019,137,40,232,275,92,639
5/17/2019,2019,138,58,201,305,102,666
5/18/2019,2019,139,32,231,314,97,674
5/19/2019,2019,140,44,189,362,96,691
5/20/2019,2019,141,36,236,307,115,694
5/21/2019,2019,142,38,208,275,113,634
5/22/2019,2019,143,41,209,316,109,675
5/23/2019,2019,144,44,217,310,88,659
5/24/2019,2019,145,47,247,312,128,734
5/25/2019,2019,146,33,232,374,103,742
5/26/2019,2019,147,38,204,375,86,703
5/27/2019,2019,148,37,218,297,93,645
5/28/2019,2019,149,32,232,274,108,646
5/29/2019,2019,150,26,223,290,91,630
5/30/2019,2019,151,37,223,277,105,642
5/31/2019,2019,152,43,245,324,108,720
6/1/2019,2019,153,47,246,337,152,782
6/2/2019,2019,154,26,221,326,70,643
6/3/2019,2019,155,41,206,260,106,613
6/4/2019,2019,156,36,214,313,104,667
6/5/2019,2019,157,45,247,300,109,701
6/6/2019,2019,158,38,227,270,116,651
6/7/2019,2019,159,59,233,313,110,715
6/8/2019,2019,160,46,300,341,88,775
6/9/2019,2019,161,27,241,352,77,697
6/10/2019,2019,162,34,262,303,112,711
6/11/2019,2019,163,44,245,305,80,674
6/12/2019,2019,164,39,235,262,96,632
6/13/2019,2019,165,41,218,277,82,618
6/14/2019,2019,166,41,243,319,100,703
6/15/2019,2019,167,38,233,345,110,726
6/16/2019,2019,168,28,193,335,81,637
6/17/2019,2019,169,32,215,296,107,650
6/18/2019,2019,170,45,224,277,88,634
6/19/2019,2019,171,70,225,293,122,710
6/20/2019,2019,172,38,224,276,109,647
6/21/2019,2019,173,64,239,283,112,698
6/22/2019,2019,174,38,260,324,86,708
6/23/2019,2019,175,37,236,363,89,725
6/24/2019,2019,176,41,234,322,122,719
6/25/2019,2019,177,36,257,281,106,680
6/26/2019,2019,178,34,265,303,107,709
6/27/2019,2019,179,46,252,264,88,650
6/28/2019,2019,180,45,276,316,103,740
6/29/2019,2019,181,46,268,349,108,771
6/30/2019,2019,182,28,255,378,64,725
7/1/2019,2019,183,38,281,323,145,787
7/2/2019,2019,184,44,219,287,120,670
7/3/2019,2019,185,51,249,288,124,712
7/4/2019,2019,186,34,186,369,85,674
7/5/2019,2019,187,47,230,375,115,767
7/6/2019,2019,188,35,214,332,106,687
7/7/2019,2019,189,36,208,352,83,679
7/8/2019,2019,190,43,269,297,113,722
7/9/2019,2019,191,47,219,277,99,642
7/10/2019,2019,192,46,271,300,106,723
7/11/2019,2019,193,25,223,317,104,669
7/12/2019,2019,194,51,239,285,117,692
7/13/2019,2019,195,36,241,370,83,730
7/14/2019,2019,196,37,227,352,79,695
7/15/2019,2019,197,48,254,297,110,709
7/16/2019,2019,198,32,237,283,103,655
7/17/2019,2019,199,48,275,262,105,690
7/18/2019,2019,200,34,259,268,101,662
7/19/2019,2019,201,43,251,296,108,698
7/20/2019,2019,202,43,264,307,93,707
7/21/2019,2019,203,30,225,337,86,678
7/22/2019,2019,204,32,261,278,103,674
7/23/2019,2019,205,36,282,259,101,678
7/24/2019,2019,206,33,278,249,87,647
7/25/2019,2019,207,41,269,277,118,705
7/26/2019,2019,208,63,261,281,104,709
7/27/2019,2019,209,43,268,323,78,712
7/28/2019,2019,210,53,239,357,62,711
7/29/2019,2019,211,51,252,303,114,720
7/30/2019,2019,212,50,257,256,109,672
7/31/2019,2019,213,31,250,242,96,619
8/1/2019,2019,214,57,314,266,160,797
8/2/2019,2019,215,52,340,279,113,784
8/3/2019,2019,216,50,295,327,91,763
8/4/2019,2019,217,42,289,347,68,746
8/5/2019,2019,218,43,249,318,92,702
8/6/2019,2019,219,49,235,291,99,674
8/7/2019,2019,220,68,256,271,83,678
8/8/2019,2019,221,44,275,265,125,709
8/9/2019,2019,222,39,266,279,100,684
8/10/2019,2019,223,25,229,334,78,666
8/11/2019,2019,224,35,246,336,76,693
8/12/2019,2019,225,45,256,248,83,632
8/13/2019,2019,226,48,240,256,109,653
8/14/2019,2019,227,50,241,294,105,690
8/15/2019,2019,228,44,250,302,110,706
8/16/2019,2019,229,62,230,263,100,655
8/17/2019,2019,230,41,256,329,75,701
8/18/2019,2019,231,37,193,341,86,657
8/19/2019,2019,232,48,239,278,125,690
8/20/2019,2019,233,47,218,275,115,655
8/21/2019,2019,234,56,251,234,97,638
8/22/2019,2019,235,37,239,275,114,665
8/23/2019,2019,236,59,262,270,87,678
8/24/2019,2019,237,45,249,328,79,701
8/25/2019,2019,238,43,210,359,71,683
8/26/2019,2019,239,41,218,252,104,615
8/27/2019,2019,240,44,238,260,89,631
8/28/2019,2019,241,40,261,258,97,656
8/29/2019,2019,242,38,258,264,104,664
8/30/2019,2019,243,66,231,277,95,669
8/31/2019,2019,244,47,250,278,80,655
9/1/2019,2019,245,44,257,323,116,740
9/2/2019,2019,246,33,242,301,79,655
9/3/2019,2019,247,46,218,229,95,588
9/4/2019,2019,248,47,233,221,104,605
9/5/2019,2019,249,34,202,235,96,567
9/6/2019,2019,250,51,244,262,101,658
9/7/2019,2019,251,42,230,307,77,656
9/8/2019,2019,252,29,195,320,83,627
9/9/2019,2019,253,42,227,269,131,669
9/10/2019,2019,254,31,228,268,97,624
9/11/2019,2019,255,56,207,277,101,641
9/12/2019,2019,256,41,254,307,86,688
9/13/2019,2019,257,47,234,331,93,705
9/14/2019,2019,258,49,214,317,69,649
9/15/2019,2019,259,29,199,347,90,665
9/16/2019,2019,260,40,257,288,108,693
9/17/2019,2019,261,40,221,299,107,667
9/18/2019,2019,262,46,219,298,93,656
9/19/2019,2019,263,41,225,308,110,684
9/20/2019,2019,264,49,268,279,114,710
9/21/2019,2019,265,33,248,305,82,668
9/22/2019,2019,266,25,206,265,74,570
9/23/2019,2019,267,33,246,290,92,661
9/24/2019,2019,268,45,217,268,109,639
9/25/2019,2019,269,52,202,259,102,615
9/26/2019,2019,270,34,212,258,108,612
9/27/2019,2019,271,31,225,226,96,578
9/28/2019,2019,272,43,221,259,86,609
9/29/2019,2019,273,31,223,309,76,639
9/30/2019,2019,274,41,239,257,123,660
10/1/2019,2019,275,55,241,285,184,765
10/2/2019,2019,276,40,231,249,99,619
10/3/2019,2019,277,48,230,235,123,636
10/4/2019,2019,278,53,225,248,86,612
10/5/2019,2019,279,49,217,293,79,638
10/6/2019,2019,280,34,215,262,59,570
10/7/2019,2019,281,51,211,285,100,647
10/8/2019,2019,282,44,225,269,85,623
10/9/2019,2019,283,51,209,256,109,625
10/10/2019,2019,284,46,185,226,101,558
10/11/2019,2019,285,44,222,257,109,632
10/12/2019,2019,286,48,234,260,98,640
10/13/2019,2019,287,22,215,294,90,621
10/14/2019,2019,288,41,218,232,90,581
10/15/2019,2019,289,37,241,245,122,645
10/16/2019,2019,290,40,243,244,129,656
10/17/2019,2019,291,33,218,231,111,593
10/18/2019,2019,292,39,228,234,123,624
10/19/2019,2019,293,32,185,317,76,610
10/20/2019,2019,294,28,216,324,74,642
10/21/2019,2019,295,29,219,276,95,619
10/22/2019,2019,296,33,191,243,93,560
10/23/2019,2019,297,33,235,250,104,622
10/24/2019,2019,298,50,245,245,89,629
10/25/2019,2019,299,44,269,256,95,664
10/26/2019,2019,300,22,182,223,59,486
10/27/2019,2019,301,24,237,281,68,610
10/28/2019,2019,302,13,214,263,83,573
10/29/2019,2019,303,45,217,209,80,551
10/30/2019,2019,304,30,192,208,93,523
10/31/2019,2019,305,28,189,217,88,522
11/1/2019,2019,306,42,241,266,180,729
11/2/2019,2019,307,30,206,281,81,598
11/3/2019,2019,308,36,211,318,77,642
11/4/2019,2019,309,46,209,241,93,589
11/5/2019,2019,310,43,186,223,100,552
11/6/2019,2019,311,40,187,233,103,563
11/7/2019,2019,312,31,208,241,99,579
11/8/2019,2019,313,46,195,219,123,583
11/9/2019,2019,314,38,224,257,94,613
11/10/2019,2019,315,33,179,277,76,565
11/11/2019,2019,316,34,152,159,77,422
11/12/2019,2019,317,33,186,161,91,471
11/13/2019,2019,318,34,199,177,90,500
11/14/2019,2019,319,36,207,186,82,511
11/15/2019,2019,320,44,250,251,107,652
11/16/2019,2019,321,44,197,247,93,581
11/17/2019,2019,322,36,221,275,72,604
11/18/2019,2019,323,41,223,242,87,593
11/19/2019,2019,324,29,222,234,119,604
11/20/2019,2019,325,37,235,256,107,635
11/21/2019,2019,326,29,206,237,90,562
11/22/2019,2019,327,60,217,242,104,623
11/23/2019,2019,328,44,222,276,78,620
11/24/2019,2019,329,35,195,266,102,598
11/25/2019,2019,330,38,247,212,89,586
11/26/2019,2019,331,39,219,253,92,603
11/27/2019,2019,332,34,217,213,84,548
11/28/2019,2019,333,16,134,225,61,436
11/29/2019,2019,334,34,202,239,96,571
11/30/2019,2019,335,40,245,224,72,581
12/1/2019,2019,336,39,208,249,113,609
12/2/2019,2019,337,41,254,219,112,626
12/3/2019,2019,338,43,254,212,101,610
12/4/2019,2019,339,48,255,250,98,651
12/5/2019,2019,340,35,244,259,96,634
12/6/2019,2019,341,35,266,258,88,647
12/7/2019,2019,342,43,262,231,68,604
12/8/2019,2019,343,31,170,289,83,573
12/9/2019,2019,344,39,245,237,90,611
12/10/2019,2019,345,34,246,217,92,589
12/11/2019,2019,346,30,191,213,97,531
12/12/2019,2019,347,26,239,232,92,589
12/13/2019,2019,348,29,246,264,99,638
12/14/2019,2019,349,24,256,254,79,613
12/15/2019,2019,350,31,199,233,103,566
12/16/2019,2019,351,25,202,225,85,537
12/17/2019,2019,352,28,219,220,108,575
12/18/2019,2019,353,44,245,205,90,584
12/19/2019,2019,354,22,252,216,99,589
12/20/2019,2019,355,39,270,214,97,620
12/21/2019,2019,356,37,257,272,87,653
12/22/2019,2019,357,39,213,250,80,582
12/23/2019,2019,358,37,238,241,89,605
12/24/2019,2019,359,24,221,247,56,548
12/25/2019,2019,360,9,122,275,44,450
12/26/2019,2019,361,44,167,236,75,522
12/27/2019,2019,362,55,240,204,111,610
12/28/2019,2019,363,45,190,224,97,556
12/29/2019,2019,364,46,216,273,71,606
12/30/2019,2019,365,32,215,223,76,546
12/31/2019,2019,1,32,166,199,80,477
1/1/2020,2020,2,30,159,398,189,776
1/2/2020,2020,3,30,213,205,94,542
1/3/2020,2020,4,52,195,239,112,598
1/4/2020,2020,5,40,188,252,66,546
1/5/2020,2020,6,44,180,234,81,539
1/6/2020,2020,7,47,212,239,97,595
1/7/2020,2020,8,42,187,214,109,552
1/8/2020,2020,9,38,193,234,97,562
1/9/2020,2020,10,41,204,189,102,536
1/10/2020,2020,11,37,212,197,87,533
1/11/2020,2020,12,45,175,194,75,489
1/12/2020,2020,13,30,189,223,71,513
1/13/2020,2020,14,36,201,231,118,586
1/14/2020,2020,15,46,208,209,111,574
1/15/2020,2020,16,38,191,212,114,555
1/16/2020,2020,17,37,211,246,103,597
1/17/2020,2020,18,41,201,202,68,512
1/18/2020,2020,19,38,179,212,73,502
1/19/2020,2020,20,30,163,198,59,450
1/20/2020,2020,21,56,200,204,89,549
1/21/2020,2020,22,39,192,186,95,512
1/22/2020,2020,23,41,168,240,93,542
1/23/2020,2020,24,57,180,190,81,508
1/24/2020,2020,25,34,214,211,98,557
1/25/2020,2020,26,52,183,220,107,562
1/26/2020,2020,27,32,176,222,80,510
1/27/2020,2020,28,43,207,241,127,618
1/28/2020,2020,29,49,215,220,96,580
1/29/2020,2020,30,43,188,197,99,527
1/30/2020,2020,31,51,195,215,87,548
1/31/2020,2020,32,53,216,242,106,617
2/1/2020,2020,33,38,240,276,137,691
2/2/2020,2020,34,35,191,306,69,601
2/3/2020,2020,35,55,231,254,96,636
2/4/2020,2020,36,60,178,227,99,564
2/5/2020,2020,37,46,230,191,94,561
2/6/2020,2020,38,44,182,181,83,490
2/7/2020,2020,39,51,203,235,114,603
2/8/2020,2020,40,33,194,234,80,541
2/9/2020,2020,41,34,163,213,60,470
2/10/2020,2020,42,43,182,213,104,542
2/11/2020,2020,43,46,182,210,106,544
2/12/2020,2020,44,37,203,202,97,539
2/13/2020,2020,45,36,162,200,91,489
2/14/2020,2020,46,28,203,202,97,530
2/15/2020,2020,47,27,185,239,77,528
2/16/2020,2020,48,30,176,241,85,532
2/17/2020,2020,49,37,168,229,86,520
2/18/2020,2020,50,39,207,247,97,590
2/19/2020,2020,51,31,181,200,76,488
2/20/2020,2020,52,42,202,178,111,533
2/21/2020,2020,53,55,209,219,78,561
2/22/2020,2020,54,43,185,282,80,590
2/23/2020,2020,55,38,171,280,64,553
2/24/2020,2020,56,40,207,191,86,524
2/25/2020,2020,57,33,146,193,80,452
2/26/2020,2020,58,49,153,224,97,523
2/27/2020,2020,59,39,163,191,95,488
2/28/2020,2020,60,45,196,233,92,566
2/29/2020,2020,61,43,173,224,78,518
3/1/2020,2020,62,41,178,296,125,640
3/2/2020,2020,63,31,176,221,96,524
3/3/2020,2020,64,40,177,226,106,549
3/4/2020,2020,65,42,180,234,105,561
3/5/2020,2020,66,39,171,218,85,513
3/6/2020,2020,67,42,206,258,108,614
3/7/2020,2020,68,24,162,245,72,503
3/8/2020,2020,69,40,173,280,62,555
3/9/2020,2020,70,33,169,221,74,497
3/10/2020,2020,71,43,164,203,83,493
3/11/2020,2020,72,40,187,223,83,533
3/12/2020,2020,73,49,150,254,100,553
3/13/2020,2020,74,46,199,263,88,596
3/14/2020,2020,75,35,176,265,58,534
3/15/2020,2020,76,22,147,267,76,512
3/16/2020,2020,77,29,151,204,84,468
3/17/2020,2020,78,29,159,224,91,503
3/18/2020,2020,79,23,152,225,61,461
3/19/2020,2020,80,17,139,200,58,414
3/20/2020,2020,81,6,138,234,76,454
3/21/2020,2020,82,6,113,213,54,386
3/22/2020,2020,83,7,86,180,52,325
3/23/2020,2020,84,9,113,174,58,354
3/24/2020,2020,85,3,108,202,66,379
3/25/2020,2020,86,8,101,206,63,378
3/26/2020,2020,87,8,134,180,55,377
3/27/2020,2020,88,9,112,184,57,362
3/28/2020,2020,89,9,130,223,54,416
3/29/2020,2020,90,2,146,240,49,437
3/30/2020,2020,91,5,133,194,67,399
3/31/2020,2020,92,4,125,173,40,342
4/1/2020,2020,93,1,147,200,120,468
4/2/2020,2020,94,2,121,163,43,329
4/3/2020,2020,95,2,141,233,64,440
4/4/2020,2020,96,5,115,213,63,396
4/5/2020,2020,97,4,109,193,48,354
4/6/2020,2020,98,5,126,197,61,389
4/7/2020,2020,99,1,121,213,48,383
4/8/2020,2020,100,7,106,210,64,387
4/9/2020,2020,101,4,125,189,58,376
4/10/2020,2020,102,10,115,164,66,355
4/11/2020,2020,103,6,118,221,51,396
4/12/2020,2020,104,7,106,184,40,337
4/13/2020,2020,105,4,119,182,46,351
4/14/2020,2020,106,3,113,147,54,317
4/15/2020,2020,107,10,120,158,78,366
4/16/2020,2020,108,8,107,188,52,355
4/17/2020,2020,109,8,127,166,69,370
4/18/2020,2020,110,3,109,216,63,391
4/19/2020,2020,111,4,79,169,44,296
4/20/2020,2020,112,12,130,197,84,423
4/21/2020,2020,113,7,121,174,71,373
4/22/2020,2020,114,11,139,165,69,384
4/23/2020,2020,115,8,160,148,70,386
4/24/2020,2020,116,4,132,176,64,376
4/25/2020,2020,117,7,111,188,51,357
4/26/2020,2020,118,6,100,211,54,371
4/27/2020,2020,119,7,121,164,62,354
4/28/2020,2020,120,7,120,205,65,397
4/29/2020,2020,121,9,130,175,53,367
4/30/2020,2020,122,7,130,180,64,381
5/1/2020,2020,123,4,147,220,139,510
5/2/2020,2020,124,9,127,235,54,425
5/3/2020,2020,125,15,119,244,58,436
5/4/2020,2020,126,12,129,192,59,392
5/5/2020,2020,127,16,130,170,76,392
5/6/2020,2020,128,14,150,181,62,407
5/7/2020,2020,129,9,119,166,53,347
5/8/2020,2020,130,9,130,185,57,381
5/9/2020,2020,131,15,126,216,43,400
5/10/2020,2020,132,10,120,236,56,422
5/11/2020,2020,133,13,130,181,69,393
5/12/2020,2020,134,16,117,208,47,388
5/13/2020,2020,135,12,142,227,67,448
5/14/2020,2020,136,17,130,204,59,410
5/15/2020,2020,137,23,140,235,73,471
5/16/2020,2020,138,18,135,294,55,502
5/17/2020,2020,139,6,107,237,37,387
5/18/2020,2020,140,13,130,214,77,434
5/19/2020,2020,141,14,140,183,83,420
5/20/2020,2020,142,27,158,233,59,477
5/21/2020,2020,143,27,148,182,75,432
5/22/2020,2020,144,22,124,219,72,437
5/23/2020,2020,145,24,128,240,59,451
5/24/2020,2020,146,22,123,274,48,467
5/25/2020,2020,147,16,130,329,53,528
5/26/2020,2020,148,28,134,284,59,505
5/27/2020,2020,149,30,149,245,70,494
5/28/2020,2020,150,19,143,270,49,481
5/29/2020,2020,151,15,147,253,62,477
5/30/2020,2020,152,4,183,388,37,612
5/31/2020,2020,153,5,306,525,41,877
6/1/2020,2020,154,13,167,324,111,615
6/2/2020,2020,155,6,131,323,59,519
6/3/2020,2020,156,13,148,297,48,506
6/4/2020,2020,157,15,117,245,69,446
6/5/2020,2020,158,14,153,225,65,457
6/6/2020,2020,159,7,136,250,60,453
6/7/2020,2020,160,10,127,268,65,470
6/8/2020,2020,161,10,132,218,76,436
6/9/2020,2020,162,13,144,202,61,420
6/10/2020,2020,163,9,125,230,67,431
6/11/2020,2020,164,21,140,257,62,480
6/12/2020,2020,165,17,155,276,72,520
6/13/2020,2020,166,8,123,274,35,440
6/14/2020,2020,167,6,132,280,49,467
6/15/2020,2020,168,12,149,262,88,511
6/16/2020,2020,169,7,156,234,84,481
6/17/2020,2020,170,14,155,267,88,524
6/18/2020,2020,171,14,154,272,86,526
6/19/2020,2020,172,10,167,259,82,518
6/20/2020,2020,173,7,144,347,70,568
6/21/2020,2020,174,8,149,314,60,531
6/22/2020,2020,175,9,171,335,78,593
6/23/2020,2020,176,10,171,247,79,507
6/24/2020,2020,177,17,138,267,84,506
6/25/2020,2020,178,15,156,286,73,530
6/26/2020,2020,179,12,168,249,58,487
6/27/2020,2020,180,6,151,286,61,504
6/28/2020,2020,181,12,166,299,51,528
6/29/2020,2020,182,13,153,243,75,484
6/30/2020,2020,183,11,167,258,79,515
7/1/2020,2020,184,8,164,284,123,579
7/2/2020,2020,185,23,167,275,85,550
7/3/2020,2020,186,15,202,280,94,591
7/4/2020,2020,187,13,158,378,59,608
7/5/2020,2020,188,25,159,359,61,604
7/6/2020,2020,189,22,173,274,87,556
7/7/2020,2020,190,7,164,245,81,497
7/8/2020,2020,191,19,157,240,64,480
7/9/2020,2020,192,14,153,251,67,485
7/10/2020,2020,193,28,167,302,82,579
7/11/2020,2020,194,8,168,303,51,530
7/12/2020,2020,195,9,159,311,43,522
7/13/2020,2020,196,12,189,293,81,575
7/14/2020,2020,197,16,185,239,87,527
7/15/2020,2020,198,11,181,252,96,540
7/16/2020,2020,199,19,164,239,85,507
7/17/2020,2020,200,13,174,283,91,561
7/18/2020,2020,201,8,188,301,61,558
7/19/2020,2020,202,14,161,317,59,551
7/20/2020,2020,203,10,190,263,109,572
7/21/2020,2020,204,17,172,265,101,555
7/22/2020,2020,205,22,168,237,89,516
7/23/2020,2020,206,13,164,227,76,480
7/24/2020,2020,207,21,183,246,96,546
7/25/2020,2020,208,18,178,287,68,551
7/26/2020,2020,209,30,171,326,59,586
7/27/2020,2020,210,10,177,268,78,533
7/28/2020,2020,211,13,188,252,87,540
7/29/2020,2020,212,26,174,268,76,544
7/30/2020,2020,213,31,175,240,84,530
7/31/2020,2020,214,22,187,238,93,540
8/1/2020,2020,215,19,169,273,121,582
8/2/2020,2020,216,16,164,254,57,491
8/3/2020,2020,217,15,204,239,89,547
8/4/2020,2020,218,18,156,226,58,458
8/5/2020,2020,219,27,164,247,58,496
8/6/2020,2020,220,28,187,228,83,526
8/7/2020,2020,221,27,151,264,63,505
8/8/2020,2020,222,13,206,273,62,554
8/9/2020,2020,223,13,158,321,50,542
8/10/2020,2020,224,8,204,287,76,575
8/11/2020,2020,225,15,188,228,79,510
8/12/2020,2020,226,27,167,245,64,503
8/13/2020,2020,227,38,182,261,75,556
8/14/2020,2020,228,31,193,247,70,541
8/15/2020,2020,229,9,171,286,64,530
8/16/2020,2020,230,15,174,322,67,578
8/17/2020,2020,231,19,205,267,78,569
8/18/2020,2020,232,16,178,269,83,546
8/19/2020,2020,233,11,207,252,78,548
8/20/2020,2020,234,14,196,261,82,553
8/21/2020,2020,235,16,227,242,84,569
8/22/2020,2020,236,15,164,293,61,533
8/23/2020,2020,237,10,168,309,53,540
8/24/2020,2020,238,11,198,280,73,562
8/25/2020,2020,239,21,220,226,76,543
8/26/2020,2020,240,15,191,261,83,550
8/27/2020,2020,241,14,186,247,81,528
8/28/2020,2020,242,21,195,267,75,558
8/29/2020,2020,243,16,173,277,66,532
8/30/2020,2020,244,22,159,305,66,552
8/31/2020,2020,245,12,189,317,92,610
9/1/2020,2020,246,21,200,213,126,560
9/2/2020,2020,247,17,188,237,73,515
9/3/2020,2020,248,17,172,240,72,501
9/4/2020,2020,249,20,190,264,78,552
9/5/2020,2020,250,22,174,290,79,565
9/6/2020,2020,251,17,142,283,66,508
9/7/2020,2020,252,34,154,249,65,502
9/8/2020,2020,253,17,177,190,86,470
9/9/2020,2020,254,16,196,194,73,479
9/10/2020,2020,255,17,209,202,68,496
9/11/2020,2020,256,16,225,271,68,580
9/12/2020,2020,257,19,173,243,46,481
9/13/2020,2020,258,10,176,266,55,507
9/14/2020,2020,259,10,190,243,72,515
9/15/2020,2020,260,13,192,243,81,529
9/16/2020,2020,261,15,179,256,79,529
9/17/2020,2020,262,11,145,223,78,457
9/18/2020,2020,263,18,165,235,76,494
9/19/2020,2020,264,15,182,231,65,493
9/20/2020,2020,265,13,151,288,83,535
9/21/2020,2020,266,25,172,212,69,478
9/22/2020,2020,267,23,152,203,81,459
9/23/2020,2020,268,25,204,258,72,559
9/24/2020,2020,269,22,165,227,69,483
9/25/2020,2020,270,28,201,282,93,604
9/26/2020,2020,271,20,173,300,57,550
9/27/2020,2020,272,14,168,319,64,565
9/28/2020,2020,273,22,165,214,83,484
9/29/2020,2020,274,21,144,199,88,452
9/30/2020,2020,275,20,160,232,76,488
10/1/2020,2020,276,13,170,220,144,547
10/2/2020,2020,277,24,159,196,97,476
10/3/2020,2020,278,10,181,262,77,530
10/4/2020,2020,279,14,160,261,79,514
10/5/2020,2020,280,26,170,211,84,491
10/6/2020,2020,281,30,152,245,90,517
10/7/2020,2020,282,19,194,236,96,545
10/8/2020,2020,283,20,170,210,89,489
10/9/2020,2020,284,18,185,265,102,570
10/10/2020,2020,285,30,200,297,63,590
10/11/2020,2020,286,23,143,309,88,563
10/12/2020,2020,287,19,165,243,85,512
10/13/2020,2020,288,21,180,218,82,501
10/14/2020,2020,289,19,209,247,110,585
10/15/2020,2020,290,21,194,223,119,557
10/16/2020,2020,291,22,156,207,86,471
10/17/2020,2020,292,22,190,249,70,531
10/18/2020,2020,293,21,136,215,112,484
10/19/2020,2020,294,17,159,189,106,471
10/20/2020,2020,295,21,157,174,139,491
10/21/2020,2020,296,26,167,204,117,514
10/22/2020,2020,297,21,169,224,122,536
10/23/2020,2020,298,24,170,206,109,509
10/24/2020,2020,299,15,140,241,64,460
10/25/2020,2020,300,17,149,255,134,555
10/26/2020,2020,301,18,147,204,112,481
10/27/2020,2020,302,17,150,180,107,454
10/28/2020,2020,303,27,160,178,103,468
10/29/2020,2020,304,20,147,208,127,502
10/30/2020,2020,305,18,177,219,104,518
10/31/2020,2020,306,12,171,271,89,543
11/1/2020,2020,307,13,166,272,137,588
11/2/2020,2020,308,15,154,188,161,518
11/3/2020,2020,309,13,161,226,132,532
11/4/2020,2020,310,14,177,236,141,568
11/5/2020,2020,311,21,170,232,143,566
11/6/2020,2020,312,22,191,244,127,584
11/7/2020,2020,313,23,151,261,91,526
11/8/2020,2020,314,23,132,265,73,493
11/9/2020,2020,315,18,154,229,132,533
11/10/2020,2020,316,16,185,201,132,534
11/11/2020,2020,317,16,131,182,91,420
11/12/2020,2020,318,19,144,192,107,462
11/13/2020,2020,319,17,153,180,108,458
11/14/2020,2020,320,18,137,203,65,423
11/15/2020,2020,321,13,139,230,73,455
11/16/2020,2020,322,19,150,186,99,454
11/17/2020,2020,323,26,153,176,99,454
11/18/2020,2020,324,16,174,170,91,451
11/19/2020,2020,325,11,170,219,82,482
11/20/2020,2020,326,13,196,240,116,565
11/21/2020,2020,327,12,177,201,58,448
11/22/2020,2020,328,18,143,205,78,444
11/23/2020,2020,329,16,165,204,86,471
11/24/2020,2020,330,15,159,164,101,439
11/25/2020,2020,331,22,147,177,83,429
11/26/2020,2020,332,3,86,180,41,310
11/27/2020,2020,333,26,154,217,75,472
11/28/2020,2020,334,17,151,175,57,400
11/29/2020,2020,335,21,136,218,85,460
11/30/2020,2020,336,11,146,167,104,428
12/1/2020,2020,337,18,179,161,173,531
12/2/2020,2020,338,17,158,164,107,446
12/3/2020,2020,339,25,154,141,94,414
12/4/2020,2020,340,13,172,181,132,498
12/5/2020,2020,341,22,158,225,84,489
12/6/2020,2020,342,22,137,204,119,482
12/7/2020,2020,343,18,147,186,132,483
12/8/2020,2020,344,14,160,177,134,485
12/9/2020,2020,345,23,146,181,120,470
12/10/2020,2020,346,28,151,185,151,515
12/11/2020,2020,347,16,144,167,116,443
12/12/2020,2020,348,15,138,199,93,445
12/13/2020,2020,349,19,140,205,111,475
12/14/2020,2020,350,17,131,180,146,474
12/15/2020,2020,351,21,164,146,184,515
12/16/2020,2020,352,18,126,188,136,468
12/17/2020,2020,353,14,148,163,132,457
12/18/2020,2020,354,19,147,164,156,486
12/19/2020,2020,355,13,149,213,66,441
12/20/2020,2020,356,15,136,206,113,470
12/21/2020,2020,357,20,145,188,189,542
12/22/2020,2020,358,9,167,188,144,508
12/23/2020,2020,359,21,153,189,145,508
12/24/2020,2020,360,3,148,172,115,438
12/25/2020,2020,361,4,81,216,44,345
12/26/2020,2020,362,12,105,177,74,368
12/27/2020,2020,363,18,128,206,77,429
12/28/2020,2020,364,18,141,180,119,458
12/29/2020,2020,365,14,98,160,102,374
12/30/2020,2020,1,18,120,144,146,428
12/31/2020,2020,2,12,119,217,119,467
1/1/2021,2021,3,12,108,290,154,564
1/2/2021,2021,4,20,114,158,89,381
1/3/2021,2021,5,24,120,214,80,438
1/4/2021,2021,6,14,123,176,137,450
1/5/2021,2021,7,21,144,180,123,468
1/6/2021,2021,8,22,118,158,133,431
1/7/2021,2021,9,18,173,175,129,495
1/8/2021,2021,10,22,167,217,114,520
1/9/2021,2021,11,24,125,204,69,422
1/10/2021,2021,12,17,128,207,129,481
1/11/2021,2021,13,16,146,165,112,439
1/12/2021,2021,14,18,165,192,132,507
1/13/2021,2021,15,10,134,181,125,450
1/14/2021,2021,16,12,153,169,133,467
1/15/2021,2021,17,18,156,205,133,512
1/16/2021,2021,18,11,132,223,52,418
1/17/2021,2021,19,7,152,210,112,481
1/18/2021,2021,20,12,152,172,79,415
1/19/2021,2021,21,16,148,193,104,461
1/20/2021,2021,22,14,150,167,148,479
1/21/2021,2021,23,12,163,170,172,517
1/22/2021,2021,24,14,118,175,152,459
1/23/2021,2021,25,11,143,232,56,442
1/24/2021,2021,26,15,132,215,80,442
1/25/2021,2021,27,13,132,188,146,479
1/26/2021,2021,28,23,103,160,116,402
1/27/2021,2021,29,25,135,163,157,480
1/28/2021,2021,30,27,131,146,126,430
1/29/2021,2021,31,22,124,171,125,442
1/30/2021,2021,32,13,127,191,75,406
1/31/2021,2021,33,1,77,172,55,305
2/1/2021,2021,34,17,108,187,159,471
2/2/2021,2021,35,22,113,195,120,450
2/3/2021,2021,36,36,115,172,116,439
2/4/2021,2021,37,18,115,167,86,386
2/5/2021,2021,38,26,122,168,106,422
2/6/2021,2021,39,15,100,180,60,355
2/7/2021,2021,40,5,93,188,65,351
2/8/2021,2021,41,12,113,150,93,368
2/9/2021,2021,42,22,134,163,67,386
2/10/2021,2021,43,26,104,149,87,366
2/11/2021,2021,44,22,127,171,73,393
2/12/2021,2021,45,33,141,168,101,443
2/13/2021,2021,46,13,116,185,61,375
2/14/2021,2021,47,11,96,170,79,356
2/15/2021,2021,48,9,70,158,67,304
2/16/2021,2021,49,19,75,154,83,331
2/17/2021,2021,50,21,110,148,108,387
2/18/2021,2021,51,32,101,173,86,392
2/19/2021,2021,52,29,127,192,78,426
2/20/2021,2021,53,29,119,196,77,421
2/21/2021,2021,54,11,101,223,76,411
2/22/2021,2021,55,23,132,187,96,438
2/23/2021,2021,56,28,145,217,103,493
2/24/2021,2021,57,23,132,197,99,451
2/25/2021,2021,58,31,125,212,98,466
2/26/2021,2021,59,26,136,222,115,499
2/27/2021,2021,60,25,137,250,84,496
2/28/2021,2021,61,18,119,235,93,465
3/1/2021,2021,62,23,147,177,180,527
3/2/2021,2021,63,19,137,167,119,442
3/3/2021,2021,64,41,142,205,116,504
3/4/2021,2021,65,30,162,174,104,470
3/5/2021,2021,66,33,151,177,101,462
3/6/2021,2021,67,17,132,250,61,460
3/7/2021,2021,68,13,105,232,69,419
3/8/2021,2021,69,17,136,215,88,456
3/9/2021,2021,70,31,133,241,96,501
3/10/2021,2021,71,32,127,236,86,481
3/11/2021,2021,72,31,128,177,86,422
3/12/2021,2021,73,24,135,209,86,454
3/13/2021,2021,74,18,113,235,58,424
3/14/2021,2021,75,10,111,216,55,392
3/15/2021,2021,76,23,109,182,127,441
3/16/2021,2021,77,24,115,186,109,434
3/17/2021,2021,78,23,111,206,100,440
3/18/2021,2021,79,19,112,169,88,388
3/19/2021,2021,80,14,143,205,83,445
3/20/2021,2021,81,12,129,205,75,421
3/21/2021,2021,82,18,120,256,68,462
3/22/2021,2021,83,22,139,246,107,514
3/23/2021,2021,84,24,140,183,87,434
3/24/2021,2021,85,24,130,200,90,444
3/25/2021,2021,86,24,138,171,79,412
3/26/2021,2021,87,16,145,212,90,463
3/27/2021,2021,88,9,109,228,55,401
3/28/2021,2021,89,26,122,246,70,464
3/29/2021,2021,90,19,110,229,70,428
3/30/2021,2021,91,20,143,209,69,441
3/31/2021,2021,92,25,129,201,65,420
4/1/2021,2021,93,27,155,217,133,532
4/2/2021,2021,94,15,162,202,66,445
4/3/2021,2021,95,15,133,240,60,448
4/4/2021,2021,96,14,112,258,67,451
4/5/2021,2021,97,18,120,213,92,443
4/6/2021,2021,98,16,135,237,83,471
4/7/2021,2021,99,28,154,232,91,505
4/8/2021,2021,100,20,130,179,87,416
4/9/2021,2021,101,19,107,224,103,453
4/10/2021,2021,102,20,126,239,61,446
4/11/2021,2021,103,10,107,238,53,408
4/12/2021,2021,104,11,123,228,94,456
4/13/2021,2021,105,13,134,228,73,448
4/14/2021,2021,106,15,114,192,87,408
4/15/2021,2021,107,11,141,211,86,449
4/16/2021,2021,108,10,142,224,77,453
4/17/2021,2021,109,6,120,256,63,445
4/18/2021,2021,110,10,108,215,53,386
4/19/2021,2021,111,8,129,168,76,381
4/20/2021,2021,112,10,132,158,84,384
4/21/2021,2021,113,9,138,164,77,388
4/22/2021,2021,114,13,143,207,61,424
4/23/2021,2021,115,15,128,208,84,435
4/24/2021,2021,116,10,121,267,73,471
4/25/2021,2021,117,9,130,236,53,428
4/26/2021,2021,118,13,125,241,71,450
4/27/2021,2021,119,10,164,292,80,546
4/28/2021,2021,120,20,137,213,95,465
4/29/2021,2021,121,7,142,179,55,383
4/30/2021,2021,122,11,158,254,97,520
5/1/2021,2021,123,6,167,286,128,587
5/2/2021,2021,124,14,136,324,62,536
5/3/2021,2021,125,17,147,222,97,483
5/4/2021,2021,126,24,111,199,81,415
5/5/2021,2021,127,15,158,253,95,521
5/6/2021,2021,128,12,150,199,75,436
5/7/2021,2021,129,17,132,210,92,451
5/8/2021,2021,130,9,145,238,74,466
5/9/2021,2021,131,13,128,265,56,462
5/10/2021,2021,132,20,143,211,96,470
5/11/2021,2021,133,13,146,215,97,471
5/12/2021,2021,134,14,135,197,83,429
5/13/2021,2021,135,14,151,236,78,479
5/14/2021,2021,136,22,179,258,79,538
5/15/2021,2021,137,9,151,278,77,515
5/16/2021,2021,138,19,136,262,58,475
5/17/2021,2021,139,10,144,258,87,499
5/18/2021,2021,140,8,158,242,84,492
5/19/2021,2021,141,14,157,224,91,486
5/20/2021,2021,142,15,147,269,83,514
5/21/2021,2021,143,21,162,269,73,525
5/22/2021,2021,144,27,160,321,63,571
5/23/2021,2021,145,14,135,339,68,556
5/24/2021,2021,146,17,176,261,110,564
5/25/2021,2021,147,13,159,292,105,569
5/26/2021,2021,148,15,145,277,65,502
5/27/2021,2021,149,19,138,202,82,441
5/28/2021,2021,150,12,131,200,99,442
5/29/2021,2021,151,12,145,247,77,481
5/30/2021,2021,152,20,136,260,72,488
5/31/2021,2021,153,16,106,249,85,456
6/1/2021,2021,154,14,147,262,135,558
6/2/2021,2021,155,11,148,262,102,523
6/3/2021,2021,156,14,193,220,119,546
6/4/2021,2021,157,8,195,219,95,517
6/5/2021,2021,158,9,143,297,67,516
6/6/2021,2021,159,14,166,358,83,621
6/7/2021,2021,160,13,165,280,107,565
6/8/2021,2021,161,14,184,303,94,595
6/9/2021,2021,162,11,147,258,115,531
6/10/2021,2021,163,10,171,268,92,541
6/11/2021,2021,164,13,178,280,117,588
6/12/2021,2021,165,8,175,262,69,514
6/13/2021,2021,166,9,172,303,100,584
6/14/2021,2021,167,9,171,266,113,559
6/15/2021,2021,168,20,134,274,99,527
6/16/2021,2021,169,15,130,268,112,525
6/17/2021,2021,170,19,166,217,83,485
6/18/2021,2021,171,21,171,237,109,538
6/19/2021,2021,172,19,170,319,91,599
6/20/2021,2021,173,24,147,325,99,595
6/21/2021,2021,174,11,154,260,100,525
6/22/2021,2021,175,23,168,258,116,565
6/23/2021,2021,176,7,145,277,82,511
6/24/2021,2021,177,16,160,249,85,510
6/25/2021,2021,178,11,133,222,90,456
6/26/2021,2021,179,6,190,247,55,498
6/27/2021,2021,180,11,192,323,68,594
6/28/2021,2021,181,11,178,272,98,559
6/29/2021,2021,182,6,162,229,87,484
6/30/2021,2021,183,10,169,248,86,513
7/1/2021,2021,184,15,190,281,118,604
7/2/2021,2021,185,27,201,232,90,550
7/3/2021,2021,186,16,160,287,98,561
7/4/2021,2021,187,15,145,366,62,588
7/5/2021,2021,188,8,142,356,78,584
7/6/2021,2021,189,4,157,252,82,495
7/7/2021,2021,190,7,147,269,88,511
7/8/2021,2021,191,6,184,242,76,508
7/9/2021,2021,192,8,176,243,89,516
7/10/2021,2021,193,8,189,254,72,523
7/11/2021,2021,194,6,128,268,61,463
7/12/2021,2021,195,9,161,238,90,498
7/13/2021,2021,196,15,185,240,85,525
7/14/2021,2021,197,12,153,241,101,507
7/15/2021,2021,198,11,160,213,78,462
7/16/2021,2021,199,8,183,272,73,536
7/17/2021,2021,200,5,179,272,72,528
7/18/2021,2021,201,7,145,296,46,494
7/19/2021,2021,202,8,170,238,77,493
7/20/2021,2021,203,5,180,235,79,499
7/21/2021,2021,204,10,152,262,82,506
7/22/2021,2021,205,9,170,255,93,527
7/23/2021,2021,206,10,196,268,81,555
7/24/2021,2021,207,5,168,300,55,528
7/25/2021,2021,208,5,170,319,64,558
7/26/2021,2021,209,8,165,267,100,540
7/27/2021,2021,210,7,175,261,95,538
7/28/2021,2021,211,12,155,263,64,494
7/29/2021,2021,212,14,259,280,91,644
7/30/2021,2021,213,4,258,227,84,573
7/31/2021,2021,214,6,295,326,68,695
8/1/2021,2021,215,9,222,302,104,637
8/2/2021,2021,216,5,162,263,92,522
8/3/2021,2021,217,4,137,268,71,480
8/4/2021,2021,218,15,166,232,87,500
8/5/2021,2021,219,7,157,265,78,507
8/6/2021,2021,220,6,165,242,88,501
8/7/2021,2021,221,2,186,285,65,538
8/8/2021,2021,222,7,169,319,51,546
8/9/2021,2021,223,3,173,239,83,498
8/10/2021,2021,224,8,140,240,74,462
8/11/2021,2021,225,6,160,234,70,470
8/12/2021,2021,226,8,160,216,73,457
8/13/2021,2021,227,7,167,224,91,489
8/14/2021,2021,228,6,182,262,70,520
8/15/2021,2021,229,7,166,276,62,511
8/16/2021,2021,230,6,178,238,83,505
8/17/2021,2021,231,7,160,230,108,505
8/18/2021,2021,232,4,156,235,63,458
8/19/2021,2021,233,2,185,243,66,496
8/20/2021,2021,234,5,198,227,92,522
8/21/2021,2021,235,6,209,309,67,591
8/22/2021,2021,236,8,180,288,52,528
8/23/2021,2021,237,9,177,252,95,533
8/24/2021,2021,238,5,175,244,70,494
8/25/2021,2021,239,7,174,220,96,497
8/26/2021,2021,240,10,177,247,89,523
8/27/2021,2021,241,10,210,279,81,580
8/28/2021,2021,242,6,198,275,56,535
8/29/2021,2021,243,4,180,322,57,563
8/30/2021,2021,244,7,170,274,88,539
8/31/2021,2021,245,12,201,239,67,519
9/1/2021,2021,246,6,198,278,135,617
9/2/2021,2021,247,8,136,252,72,468
9/3/2021,2021,248,11,208,245,93,557
9/4/2021,2021,249,7,207,303,75,592
9/5/2021,2021,250,10,186,313,65,574
9/6/2021,2021,251,4,169,296,55,524
9/7/2021,2021,252,6,152,241,71,470
9/8/2021,2021,253,8,175,249,77,509
9/9/2021,2021,254,6,169,254,83,512
9/10/2021,2021,255,10,203,285,80,578
9/11/2021,2021,256,6,190,293,60,549
9/12/2021,2021,257,5,182,325,70,582
9/13/2021,2021,258,8,207,287,89,591
9/14/2021,2021,259,11,154,284,98,547
9/15/2021,2021,260,5,206,260,106,577
9/16/2021,2021,261,3,198,295,91,587
9/17/2021,2021,262,5,194,281,62,542
9/18/2021,2021,263,4,190,306,74,574
9/19/2021,2021,264,9,212,351,62,634
9/20/2021,2021,265,5,204,262,93,564
9/21/2021,2021,266,3,205,226,91,525
9/22/2021,2021,267,12,208,222,89,531
9/23/2021,2021,268,7,214,240,78,539
9/24/2021,2021,269,8,196,230,66,500
9/25/2021,2021,270,14,209,249,69,541
9/26/2021,2021,271,8,174,288,59,529
9/27/2021,2021,272,8,187,261,94,550
9/28/2021,2021,273,14,195,290,87,586
9/29/2021,2021,274,12,200,265,81,558
9/30/2021,2021,275,13,198,229,93,533
10/1/2021,2021,276,8,253,271,140,672
10/2/2021,2021,277,16,240,274,69,599
10/3/2021,2021,278,4,229,312,54,599
10/4/2021,2021,279,14,169,284,76,543
10/5/2021,2021,280,11,217,253,79,560
10/6/2021,2021,281,15,190,280,85,570
10/7/2021,2021,282,14,168,237,83,502
10/8/2021,2021,283,18,189,274,75,556
10/9/2021,2021,284,11,199,268,73,551
10/10/2021,2021,285,5,180,316,60,561
10/11/2021,2021,286,10,190,219,61,480
10/12/2021,2021,287,10,188,265,76,539
10/13/2021,2021,288,9,188,252,87,536
10/14/2021,2021,289,10,187,251,79,527
10/15/2021,2021,290,5,226,239,74,544
10/16/2021,2021,291,5,183,266,67,521
10/17/2021,2021,292,8,180,285,71,544
10/18/2021,2021,293,6,196,236,89,527
10/19/2021,2021,294,7,191,224,69,491
10/20/2021,2021,295,11,178,259,86,534
10/21/2021,2021,296,6,194,240,91,531
10/22/2021,2021,297,6,215,250,66,537
10/23/2021,2021,298,4,222,256,68,550
10/24/2021,2021,299,10,166,193,53,422
10/25/2021,2021,300,9,204,227,71,511
10/26/2021,2021,301,9,239,222,78,548
10/27/2021,2021,302,7,212,220,80,519
10/28/2021,2021,303,6,204,206,87,503
10/29/2021,2021,304,6,213,232,78,529
10/30/2021,2021,305,9,208,246,62,525
10/31/2021,2021,306,14,187,307,51,559
11/1/2021,2021,307,8,196,231,115,550
11/2/2021,2021,308,9,194,236,80,519
11/3/2021,2021,309,8,200,249,61,518
11/4/2021,2021,310,12,165,235,79,491
11/5/2021,2021,311,14,178,233,59,484
11/6/2021,2021,312,9,212,263,67,551
11/7/2021,2021,313,9,188,286,64,547
11/8/2021,2021,314,3,195,278,82,558
11/9/2021,2021,315,7,196,241,88,532
11/10/2021,2021,316,8,214,246,88,556
11/11/2021,2021,317,10,196,209,59,474
11/12/2021,2021,318,12,196,174,94,476
11/13/2021,2021,319,12,190,230,65,497
11/14/2021,2021,320,9,191,232,46,478
11/15/2021,2021,321,9,193,218,90,510
11/16/2021,2021,322,12,196,233,71,512
11/17/2021,2021,323,12,180,177,80,449
11/18/2021,2021,324,13,180,210,84,487
11/19/2021,2021,325,4,202,224,67,497
11/20/2021,2021,326,16,194,247,71,528
11/21/2021,2021,327,2,185,261,54,502
11/22/2021,2021,328,5,155,210,71,441
11/23/2021,2021,329,7,175,179,60,421
11/24/2021,2021,330,11,217,209,82,519
11/25/2021,2021,331,3,105,216,35,359
11/26/2021,2021,332,8,181,198,81,468
11/27/2021,2021,333,5,210,197,48,460
11/28/2021,2021,334,7,144,273,64,488
11/29/2021,2021,335,6,215,210,85,516
11/30/2021,2021,336,13,209,194,74,490
12/1/2021,2021,337,13,226,229,120,588
12/2/2021,2021,338,14,184,253,80,531
12/3/2021,2021,339,7,235,254,82,578
12/4/2021,2021,340,7,205,226,63,501
12/5/2021,2021,341,3,174,237,57,471
12/6/2021,2021,342,8,205,217,61,491
12/7/2021,2021,343,8,169,215,70,462
12/8/2021,2021,344,8,199,222,91,520
12/9/2021,2021,345,7,211,213,72,503
12/10/2021,2021,346,8,200,225,72,505
12/11/2021,2021,347,12,211,200,50,473
12/12/2021,2021,348,8,191,260,60,519
12/13/2021,2021,349,8,197,231,72,508
12/14/2021,2021,350,7,197,212,70,486
12/15/2021,2021,351,7,229,219,75,530
12/16/2021,2021,352,9,214,218,60,501
12/17/2021,2021,353,5,204,215,65,489
12/18/2021,2021,354,15,189,232,54,490
12/19/2021,2021,355,7,147,209,67,430
12/20/2021,2021,356,4,188,202,78,472
12/21/2021,2021,357,4,164,203,53,424
12/22/2021,2021,358,7,195,157,64,423
12/23/2021,2021,359,5,199,202,55,461
12/24/2021,2021,360,12,169,198,65,444
12/25/2021,2021,361,2,112,235,48,397
12/26/2021,2021,362,4,121,203,63,391
12/27/2021,2021,363,9,174,210,58,451
12/28/2021,2021,364,5,148,196,57,406
12/29/2021,2021,365,5,184,182,69,440
12/30/2021,2021,1,3,195,229,60,487
12/31/2021,2021,2,8,153,264,78,503
1/1/2022,2022,3,3,165,295,83,546
1/2/2022,2022,4,3,142,160,51,356
1/3/2022,2022,5,7,152,155,59,373
1/4/2022,2022,6,8,173,162,61,404
1/5/2022,2022,7,6,160,133,63,362
1/6/2022,2022,8,2,157,165,88,412
1/7/2022,2022,9,5,156,179,81,421
1/8/2022,2022,10,8,155,149,52,364
1/9/2022,2022,11,5,146,167,54,372
1/10/2022,2022,12,3,162,178,79,422
1/11/2022,2022,13,4,164,158,60,386
1/12/2022,2022,14,3,186,180,61,430
1/13/2022,2022,15,5,193,200,67,465
1/14/2022,2022,16,4,202,229,83,518
1/15/2022,2022,17,8,186,209,54,457
1/16/2022,2022,18,8,153,200,66,427
1/17/2022,2022,19,7,182,185,63,437
1/18/2022,2022,20,10,205,218,96,529
1/19/2022,2022,21,5,166,193,92,456
1/20/2022,2022,22,8,166,176,75,425
1/21/2022,2022,23,10,195,205,80,490
1/22/2022,2022,24,9,194,205,61,469
1/23/2022,2022,25,12,115,208,42,377
1/24/2022,2022,26,9,138,161,75,383
1/25/2022,2022,27,9,169,174,83,435
1/26/2022,2022,28,11,167,181,70,429
1/27/2022,2022,29,13,199,201,75,488
1/28/2022,2022,30,9,145,165,64,383
1/29/2022,2022,31,10,145,204,62,421
1/30/2022,2022,32,8,131,229,50,418
1/31/2022,2022,33,7,153,195,85,440
2/1/2022,2022,34,13,168,226,100,507
2/2/2022,2022,35,11,110,148,70,339
2/3/2022,2022,36,19,142,185,63,409
2/4/2022,2022,37,21,187,184,79,471
2/5/2022,2022,38,13,173,204,57,447
2/6/2022,2022,39,16,153,196,63,428
2/7/2022,2022,40,15,169,191,92,467
2/8/2022,2022,41,14,196,228,69,507
2/9/2022,2022,42,21,185,202,69,477
2/10/2022,2022,43,21,210,193,75,499
2/11/2022,2022,44,19,178,201,78,476
2/12/2022,2022,45,17,189,224,57,487
2/13/2022,2022,46,6,154,203,45,408
2/14/2022,2022,47,11,182,218,71,482
2/15/2022,2022,48,20,186,213,76,495
2/16/2022,2022,49,15,185,223,80,503
2/17/2022,2022,50,11,153,215,64,443
2/18/2022,2022,51,18,145,192,78,433
2/19/2022,2022,52,18,161,233,59,471
2/20/2022,2022,53,14,158,189,62,423
2/21/2022,2022,54,14,186,194,64,458
2/22/2022,2022,55,14,199,183,83,479
2/23/2022,2022,56,18,194,208,66,486
2/24/2022,2022,57,11,151,184,79,425
2/25/2022,2022,58,13,195,197,81,486
2/26/2022,2022,59,15,186,181,61,443
2/27/2022,2022,60,10,149,248,41,448
2/28/2022,2022,61,15,170,209,74,468
3/1/2022,2022,62,22,196,203,84,505
3/2/2022,2022,63,12,173,217,87,489
3/3/2022,2022,64,14,205,217,82,518
3/4/2022,2022,65,18,217,214,94,543
3/5/2022,2022,66,9,206,240,60,515
3/6/2022,2022,67,16,141,250,49,456
3/7/2022,2022,68,13,165,195,78,451
3/8/2022,2022,69,18,193,205,70,486
3/9/2022,2022,70,15,163,179,82,439
3/10/2022,2022,71,11,175,214,90,490
3/11/2022,2022,72,13,170,188,92,463
3/12/2022,2022,73,14,214,217,93,538
3/13/2022,2022,74,12,181,225,73,491
3/14/2022,2022,75,16,187,217,80,500
3/15/2022,2022,76,10,177,208,79,474
3/16/2022,2022,77,7,191,246,70,514
3/17/2022,2022,78,11,183,232,80,506
3/18/2022,2022,79,11,190,206,79,486
3/19/2022,2022,80,13,196,244,60,513
3/20/2022,2022,81,14,183,295,53,545
3/21/2022,2022,82,12,172,255,79,518
3/22/2022,2022,83,12,198,229,83,522
3/23/2022,2022,84,10,189,210,80,489
3/24/2022,2022,85,11,197,238,77,523
3/25/2022,2022,86,16,200,228,68,512
3/26/2022,2022,87,12,157,259,76,504
3/27/2022,2022,88,7,133,229,50,419
3/28/2022,2022,89,8,200,193,67,468
3/29/2022,2022,90,11,174,199,80,464
3/30/2022,2022,91,8,175,226,72,481
3/31/2022,2022,92,14,166,220,71,471
4/1/2022,2022,93,9,169,238,91,507
4/2/2022,2022,94,12,175,221,61,469
4/3/2022,2022,95,10,148,257,61,476
4/4/2022,2022,96,11,156,242,61,470
4/5/2022,2022,97,11,140,209,75,435
